Ms^Xm, Aa, Ms^Xm, Ms^Xm, Ms^Xm, Ms^Xm, Ms^Xm, Ms^Xm, Ms^Xm, Ms^Xm, Ms^Xm, Ms^Xm, Ms^Xm, Ms^Xm, Ms^Xm, Ms^Xm, Ms^Xm, Ms^Xm, Ms^Xm, Ms^Xm, Ms^Xm, Ms^Xm, Ms^Xm, Ms^Xm, Ms^Xm, Ms^Xm, Ms^Xm, Ms^Xm, Ms^Xm, Ms^Xm, Ms^Xm, Ms^Xm, Ms^Xm, Ms^Xm, Ms^Xm, Aa, Ms^Xm, Ms^Xm, Ms^Xm, Ms^Xm, Ms^Xm, Ms^Xm, Ms^Xm, Ms^Xm, Ms^Xm, Ms^Xm, Ms^Xm
Ms^Xm, Ms^Xm, Ms^Xm, Ms^Xm, Ms^Xm, Ms^Xm, Ms^Xm, Ms^Xm, Ms^Xm, Ms^Xm, Ms^Xm, Ms^Xm, Ms^Xm, Ms^Xm, Ms^Xm, Ms^Xm, Ms^Xm, Ms^Xm, Ms^Xm, Ms^Xm, Ms^Xm, Ms^Xm, Ms^Xm, Ms^Xm, Ms^Xm, Ms^Xm, Ms^Xm, Ms^Xm, Ms, Ms^Xm, Ms, Ms^Xm, Ms^Xm, Ms^Xm, Ms, Ms^Xm, Ms, Ms^Xm, Ms^Xm, Ms^Xm, Ms^Xm, Ms^Xm, Ms^Xm, Ms^Xm, Ms^Xm, Ms^Xm, Ms^Xm
Ms^Xm, Ms^Xm, Ms^Xm, Ms^Xm, Ms^Xm, Ms^Xm, Ms^Xm, Ms^Xm, Ms^Xm, Ms^Xm, Ms^Xm, Ms^Xm, Ms^Xm, Ms^Xm, Ms^Xm, Ms^Xm, Ms^Xm, Ms^Xm, Ms^Xm, Ms^Xm, Ms, Ms^Xm, Ms, Ms, Ms, Ms, Ms, Ms, Ms, Ms, Ms, Ms, Ms, Ms, Ms, Ms, Ms, Ms, Ms^Xm, Ms^Xm, Ms^Xm, Ms^Xm, Ms^Xm, Ms^Xm, Ms^Xm, Ms^Xm, Ms^Xm
Ms^Xm, Ms^Xm, Ms^Xm, Ms^Xm, Ms, Ms^Xm, Ms^Xm, Ms^Xm, Ms^Xm, Ms, Ms, Ms, Ms, Ms, Ms, Ms, Ms, Ms, Ms, Ms, Ha^Fpa, Ms, Ms, Ha^Fpa, Ha^Fpa, Ms, Ms, Ms, Ms, Ms, Ha^Fpa, Ha^Fpa, Md, Mv, Md, Ms, Ha^Es, Ms, Ms, Ms, Ms^Xm, Ms^Xm, Ms^Xm, Ms^Xm, Ms^Xm, Ms^Xm, Ms^Xm
Ms^Xm, Ms^Xm, Ms^Xm, Ms^Xm, Ms, Ms, Ms^Xm, Ms^Xm, Ms^Xm, Ms, Md, Mv, Md, Ha^Esa, Ms, Ms, Ms, Ms, Ms, Ha^Fpa, Ha^Fma, Ha^Fpa, Ha^Fpa, Ha, Ha^Fma, Ha^Fpa, Hhd^Fp, Ms^Xm, Ha^Fpa, Ha^Fpa, Gd^Fp, Ha^Fpa, Ha, Md, Ms, Ha^Fpa, Ha^Fpa, Ms, Ms, Ms^Xm, Ms^Xm, Ms^Xm, Ms^Xm, Ms, Ms, Ms^Xm, Ms^Xm
Ms^Xm, Ms^Xm, Ms^Xm, Ms, Ms^Xm, Ms, Ms^Xm, Ms^Xm, Ms, Ms^Xm, Ms, Md, Ha^Fpa, Ha^Esa, Ha^Fpa, Ms, Ha^Fpa, Ms, Ha^Fpa, Ha^Fpa, Ha, Ha^Fma, Ha^Fpa, Aa^Fpa, Gd^Fp, Hhd^Vd, Gd^Fmw, Hhd^Fmw, Ha^Fda, Ha^Fda, Hhd^Fdw, Hhd^Fp, Ha^Fpa, Ms, Ha^Fpa, Ha^Fpa, Ha^Fpa, Ms, Ha^Fpa, Ms, Ms, Ms, Ms, Ms, Ms^Xm, Ms^Xm, Ms^Xm
Ms^Xm, Ms^Xm, Ms^Xm, Ms^Xm, Ms^Xm, Ms, Ms, Ms^Xm, Ms, Ms, Ha^Fpa, Ha^Fpa, Ha^Fpa, Ha^Fpa, Ha^Fma, Ha^Fpa, Ha^Fda, Ha^Fpa, Re, Re, Re^Es, Aa^Fda, Hhd^Fdw, Hhd^Fdw, Re^Es, Re, Re, Re, Gd^Es, Re^Es, Aa^Fda, Aa^Fpa, Aa^Fpa, Ha^Fpa, Ha^Fma, Ha^Fpa, Hhd^Fp, Ha^Fpa, Ha^Fpa, Ms, Ms, Ms, Ms^Xm, Ms^Xm, Ms^Xm, Ms^Xm, Ms^Xm
Ms^Xm, Ms^Xm, Ms^Xm, Ms^Xm, Ms^Xm, Ms^Xm, Ms, Ms, Ms, Ms, Ms, Ha^Fpa, Ha^Fma, Ha^Fpa, Hhd^Fmw, Aa^Fma, Re, Ha^Fda, Gd, Gd, Rd, Gd, Re, Hhd^Fdw, Rd, Gd, Rd, Rd^Es, Re, Rd, Hhd, Aa^Fda, Gd^Fp, Ha^Fpa, Hhd^Fp, Hhd^Fp, Hhd^Fmw, Ha^Fpa, Ha^Fpa, Ms, Ms, Ms, Ms, Ms^Xm, Ms^Xm, Ms^Xm, Ms^Xm
Ms^Xm, Ms^Xm, Ms^Xm, Ms^Xm, Ms^Xm, Ms^Xm, Ms, Ms, Ms, Ms, Ha^Fpa, Ha^Fpa, Aa^Vka, Ha^Fma, Aa^Fpa, Re^Fdw, Gd^Fdw, Gd^Es, Hhd, Gd, Re, Re, Re, Re^Es, Re, Gd^Es, Ql, Ql, Re, Rd, Hhd, Hhd^Fmw, Gd^Es, Gd^Fdw, Re^Fmw, Hhd^Fmw, Ha^Fpa, Ha^Fma, Ha^Fpa, Hhd^Fp, Ms, Ms, Ms, Ms^Xm, Ms^Xm, Ms^Xm, Ms^Xm
Ms^Xm, Ms^Xm, Ms, Ms^Xm, Ms^Xm, Ms, Ms, Ms, Ha^Es, Ha^Fpa, Ha^Es, Ha^Fpa, Aa^Fma, Ha^Esa, Ha^Fda, Hhd^Fdw, Hhd^Es, Hhd^Es, Cte, Hhd, Ql, Rb, Rb, Rb, Ql, Re^Es, Re, Ql, Re, Hhd, Hhd^Es, Hhd^Es, Gd, Gd^Fdw, Re, Re, Hhd^Fmw, Ha^Fma, Hhd^Fp, Hhd^Fp, Ms, Ms, Ms, Ms^Xm, Ms^Xm, Ms^Xm, Ms^Xm
Ms^Xm, Ms^Xm, Ms, Ms, Ms, Ms, Md, Mv, Md, Ha^Fpa, Ha^Fma, Ha^Fma, Hhd^Fdw, Ha^Esa, Hhd^Esa, Hhd, Hhd, Cte, Kte, Cte, Ql, Qlf, Ql, Ql, Qlf, Rb^Es, Qlf, Re, Re, Hhd, Re, Rd, Rd, Gd, Gd, Re^Es, Re^Fmw, Gd^Fp, Hhd^Fp, Ha^Fpa, Ha^Fpa, Ms, Ha^Fpa, Ms, Ms^Xm, Ms^Xm, Ms^Xm
Ms^Xm, Ms^Xm, Ms^Xm, Ms^Xm, Ms^Xm, Ms, Ms, Md, Ms, Ha^Fpa, Ha^Fpa, Ha^Fda, Hhd, Hhd, Rd, Rd, Hhd, Cte, Ql, Ql, Ql, Qxu, 1 Qxu, Qxu, Ql, Qlf, Qlf, Rb, Re, Re, Ql, Ql, Hhd, Re, Gd, Re, Re, Re, Ha, Ha^Fpa, Ha^Fpa, Ha^Fpa, Ha^Fpa, Ha^Fpa, Ms^Xm, Ms^Xm, Ms^Xm
Ms^Xm, Ms^Xm, Ms^Xm, Ms^Xm, Ms^Xm, Ms^Xm, Ms, Ms^Xm, Ms, Ha, Ha^Fpa, Hhd^Fdw, Hhd, Gd, Gd^Fdw, Re^Es, Re^Es, Hhd, Ql, Ql, Ql, Qxu, Qxu, Ql, Ql, Qlf, Qlf, Qlf, Re, Hhd, Hhd, Hhd, Hhd^Es, Gd, Re^Fdw, Re, Hhd, Hhd, Ha^Esa, Ha^Vka, Ha^Esa, Ha^Fpa, Ha^Fpa, Ms^Xm, Ms^Xm, Ms^Xm, Ms^Xm
Ms, Ms, Ms, Ms^Xm, Ms^Xm, Ms^Xm, Ms, Ha, Ha^Fpa, Ha, Hhd^Fdw, Hhd^Fdw, Gd, Gd^Fdw, Rd, Rb^Es, Re, Qlf, Qlf, Ql, Ql, Ql, Ql, Ql, Re^Vd, Ql, Qlf, Rb, Rb^Es, Re, Hhd, Hhd^Es, Hhd, Hhd, Gd^Fdw, Re^Fmw, Hhd^Fmw, Hhd^Esa, Hhd^Esa, Hhd^Fp, Ha^Fpa, Ha^Fpa, Ms^Xm, Ms^Xm, Ms^Xm, Ms^Xm, Ms^Xm
Ms, Ms, Ms, Ms, Ms^Xm, Ms^Xm, Ms^Xm, Ha^Fpa, Ms^Xm, Ms^Xm, Hhd^Fdw, Hhd^Esa, Gd, Ql, Rd, Rd, Re, Re, Qlf, Ql, Ql, Ql, Ql, Ql, Ql, Qlf, Qlf, Qlf, Re, Re^Es, Qlf, Qlf, Hhd, Gd^Fdw, Gd^Fdw, Re^Fdw, Re^Fmw, Hhd, Hhd^Fmw, Hhd^Fmw, Ha^Fpa, Ha^Fpa, Ms, Ms^Xm, Ms^Xm, Ms^Xm, Ms^Xm
Ms, Ms, Ms, Ms, Ms, Ms^Xm, Ms^Xm, Ha, Ha^Fpa, Ms^Xm, Aa^Fma, Aa^Fma, Gd, Ql, Gd, Rb^Vd, Hhd, Re, Rb, Qlf, Qlf, Ql, Qlf, Ql, Qlf, Qlf, Qlf, Rb, Re, Qlf, Ql, Qlf, Hhd, Gd, Gd, Gd^Fdw, Gd^Fmw, Gd^Fmw, Hhd^Fmw, Ha^Fma, Ha^Fpa, Ha^Fpa, Ms, Ms^Xm, Ms^Xm, Ms^Xm, Ms^Xm
Ha, Ms, Ms, Ms, Ms, Ms^Xm, Ms^Xm, Ha^Fpa, Ms^Xm, Ha^Fpa, Ha^Fpa, Aa^Fma, Aa^Fma, Gd, Gd, Ql, Gd, Gd, Rb^Es, Qlf, Qlf, Qlf, Qlf, Qlf, Qlf, Qlf, Qlf, Rb, Re, Rb, Hhd, Hhd, Hhd, Re, Ql, Rd, Hhd^Fmw, Hhd^Fmw, Ha^Fma, Ha^Fma, Ha^Fpa, Ms, Ms, Ms^Xm, Ms^Xm, Ms^Xm, Ms^Xm
Ha, Ha^Fpa, Ms, Ha^Fpa, Ha^Fpa, Ms, Ms, Ms^Xm, Ms, Ms, Aa^Fpa, Ha^Fpa, Gd^Fmw, Gd^Esa, Hhd, Gd, Rd, Gd, Re, Re^Es, Re, Rb, Qlf, Qlf, Rb, Qlf, Rb, Qlf, Re, Re, Hhd, Hhd, Re, Ql, Rd, Rd, Rd^Fmw, Ha^Fma, Ha^Fpa, Ha^Fma, Md, Mv, Md, Ms^Xm, Ms^Xm, Ms^Xm, Ms^Xm
Ha, Ha, Ha, Ha, Ha^Fpa, Ha^Fpa, Ha, Ms, Aa^Fpa, Ms, Aa^Fma, Aa^Fpa, Rb, Rb, Ql, Hhd, Hhd^Es, Rd, Rd, Re^Es, Re, Re, Re, Qlf, Rb^Es, Rb, Re, Rb, Re, Re, Re, Rd, Rd, Rd, Rd, Rd^Fmw, Aa^Fma, Ha^Fma, Ha^Fpa, Ha^Vka, Ms^Xm, Md, Ms^Xm, Ms, Ms^Xm, Ms^Xm, Ms^Xm
Ms, Ms, Ms, Ha, Ha, Ha, Ha, Ha, Ha^Fpa, Aa^Fma, Gd^Fp, Hhd, Rb, Ql, Ql, Hhd^Es, Hhd^Es, Re, Rd, Re, Re, Re, Re, Re, Re^Es, Re, Hhd^Es, Rb, Hhd, Hhd, Re, Rd, Rd, Hhd^Fdw, Hhd^Esa, Hhd^Esa, Ms^Xm, Ms^Xm, Ms^Xm, Ha^Fpa, Ms^Xm, Ms^Xm, Ha^Fpa, Ms^Xm, Ha^Fpa, Ms^Xm, Ha^Fpa
Ms, Ms, Ms, Ha, Ha^Fpa, Ha^Fpa, Ha, Ha, Ha^Fpa, Hhd^Esa, Ha^Esa, Hhd, Hhd, Rb, Qlf, Hhd, Qlf, Ql, Re, Re, Re, Re^Es, Qlf, Hhd, Hhd, Hhd^Es, Hhd^Es, Re, Gd, Qlf, Qlf, Rd, Hhd^Fdw, Hhd^Fdw, Ha^Fda, Ha^Esa, Ms, Ms, Ms, Ha^Fpa, Ha^Fpa, Ms^Xm, Ha^Fpa, Ha^Fpa, Ha^Fpa, Ha^Fpa, Aa^Fpa
Ms^Xm, Ms, Ms, Ms, Ms, Ms, Ms, Ms, Ms, Ha^Fpa, Ha^Esa, Ha^Esa, Hhd^Esa, Hhd, Hhd, Qlf, Hhd, Ql, Hhd, Re, Re, Re, Rd, Ql, Hhd, Hhd, Qlf, Gd, Gd, Re, Re, Gd, Hhd, Hhd, Hhd^Esa, Ha^Fpa, Hhd^Fdw, Hhd^Fp, Hhd^Fdw, Hhd^Fp, Ha^Fpa, Ha^Fpa, Ha^Fpa, Ha^Fpa, Ha^Fpa, Ha^Fpa, Ha^Fpa
Ms^Xm, Ms^Xm, Ms^Xm, Ms^Xm, Ms^Xm, Ms, Ms^Xm, Ms, Ms, Ha^Fpa, Ms, Ha^Fpa, Ha^Esa, Hhd^Fp, Hhd^Fp, Hhd^Fmw, Hhd^Fp, Hhd, Gd, Gd, Re, Rd, Rd, Ql, Ql, Ql, Gd, Gd, Gd, Re, Re, Rd, Hhd^Es, Hhd^Esa, Hhd^Fdw, Hhd^Fdw, Ql, Qlf, Qlf, Hhd^Fp, Hhd^Fmw, Hhd^Fp, Ha^Fpa, Ha^Fpa, Ha^Fpa, Ha^Fpa, Ha^Fpa
Ms^Xm, Ms^Xm, Ms^Xm, Ms^Xm, Ms, Ms, Ms, Ms^Xm, Md, Mv, Md, Ms, Ms, Ha^Fpa, Gd^Fp, Hhd^Fmw, Re^Fmw, Hhd, Gd^Es, Gd, Gd, Rd, Gd, Rd, Re, Qlf, Qlf, Gd^Es, Gd^Es, Gd, Hhd^Es, Re, Hhd^Es, Hhd^Es, Hhd, Re^Es, Ql, Ql, Qlf, Gd^Fdw, Hhd^Fdw, Hhd^Fp, Hhd^Fdw, Ha^Fpa, Hhd^Fp, Aa^Fpa, Aa^Fpa
Ms^Xm, Ms^Xm, Ms^Xm, Ms, Ha^Fpa, Ha^Fpa, Ha^Fpa, Ms^Xm, Ha^Fpa, Md, Ms, Ms, Ha^Fpa, Ha^Fpa, Hhd^Fmw, Rb^Fmw, Rb^Fdw, Re^Fdw, Re, Gd, Gd, Gd, Gd, Rb, Rb, Re, Gd, Gd, Gd^Es, Hhd, Hhd, Hhd, Hhd, Hhd, Re^Es, Re^Es, Gd, Qlf, Gd^Fdw, Gd^Fdw, Hhd^Vhhr, Gd^Fp, Hhd^Fdw, Hhd^Fp, Ha^Fda, Hhd^Fmw, Gd^Fp
Ms^Xm, Ms^Xm, Ms^Xm, Ms, Ms, Ha^Fpa, Ha^Fpa, Ha^Vca, Rb, Ms, Ms, Ms, Hhd, Hhd^Esa, Hhd^Fp, Rb^Fdw, Rb, Re^Fdw, Gd, Gd, Gd, Gd, Hhd^Fdw, Hhd, Hhd, Gd, Ql, Gd, Gd, Qlf, Gd, Re, Hhd, Hhd, Re, Re^Es, Gd, Gd, Ql, Gd^Fp, Re, Hhd^Esa, Hhd^Esa, Hhd^Fdw, Ha^Fda, Ha^Fda, Aa^Fpa
Ha^Fpa, Ms^Xm, Ms^Xm, Ms^Xm, Ms^Xm, Ha^Fma, Hhd, Hhd, Qlf, Rb^Es, Hhd, Hhd, Rb, Rb, Re, Hhd, Rb, Re, Re, Gd, Re, Re^Fdw, Qlf, Qlf, Hhd^Vhhr, Hhd, Hhd, Ql, Re, Re, Hhd^Fdw, Re, Re, Hhd, Re, Re, Gd, Gd, Re, Gd, Re^Es, Re^Es, Hhd^Fdw, Ha^Fda, Ha^Fda, Aa^Fpa, Aa^Fpa
Ha^Fpa, Ha^Fpa, Ha^Fma, Ms, Ha^Fpa, Ms^Xm, Hhd, Rb, Qlf, Qlf, Hhd, Hhd, Rb, Hhd, Hhd, Re, Gd^Es, Re, Re, Re, Re, Re^Fdw, Re, Ql, Ql, Hhd, Hhd, Re, Re, Qlf, Qlf, Gd^Fdw, Gd, Re, Re, Gd, Gd^Es, Gd^Es, Hhd, Re, Re^Es, Hhd, Hhd, Ha^Esa, Ha^Esa, Ha^Fda, Ha
Ha^Fma, Ha^Fma, Ha^Fma, Ha^Fma, Hhd^Fp, Rb, Ql, Qlf, Rb, Qlf, Hhd, Hhd, Re, Re, Hhd, Re, Re^Es, Re^Es, Rb, Rb, Rb, Re, Ql, Re, Ql, Ql, Rb, Re, Ql, Ql, Gd, Gd, Re, Re, Re, Re, Re, Re^Es, Hhd, Hhd^Es, Ha^Es, Ha, Ha, Cfa, Hhd, Ha^Fda, Ha
Ha, Ha^Esa, Ha^Fma, Ha^Fma, Rb^Es, Rb^Es, Ql, Rb, Hhd, Hhd, Ha^Esa, Hhd, Hhd, Hhd, Hhd, Hhd, Re, Rb, Qlf, Qlf, Rb^Es, Qlf, Rb, Re, Gd^Es, Ql, Gd, Rb, Gd, Ql, Ql, Re, Re, Re, Hhd, Re, Re, Hhd, Hhd, Hhd^Esa, Ha^Esa, Cfa, Cfa, Cfa, Hhd, Ha^Fda, Ha
Ha^Fma, Ha^Vca, Ha^Fda, Hhd^Fmw, Re, Re, Hhd, Ql, Re, Ha, Ha^Esa, Hhd, Ha^Esa, Ha^Esa, Hhd, Hhd, Hhd, Ql, Hhd^Fdw, Rb, Hhd^Fdw, Rb^Es, Qlf, Qlf, Re, Gd^Es, Re^Fdw, Rb^Fdw, Gd, Ql, Rb, Re, Re^Fdw, Re^Fdw, Hhd, Hhd, Hhd, Re, Hhd, Hhd^Esa, Hhd, Cfa, 3 Kfa, Hhd, Hhd^Esa, Hhd^Esa, Hhd
Ha, Ha^Fma, Ha^Fma, Hhd, Cfa, Qlf, Hhd, Hhd, Re, Ha^Esa, Ha^Esa, Re, Ha, Ha^Fda, Hhd, Hhd^Fdw, Hhd^Fdw, Ql, Ql, Hhd^Fdw, Hhd, Ql, Ql, Ql, Ql, Hhd, Hhd^Fdw, Hhd^Fdw, Rb, Qlf, Rb, Rb, Rb, Re, Hhd, Hhd^Fdw, Ha^Fda, Ha, Ha, Ha, Ha^Esa, Hhd, Hhd^Fmw, Hhd, Hhd^Vca, Hhd^Esa, Ha^Fma
Ha^Fma, Ha, Ha, Cfa, 4 Kfa, Hhd, Ha, Ha^Esa, Ha^Esa, Ha, Ha^Es, Ha^Es, Re^Fdw, Re^Fdw, Hhd^Fdw, Hhd, Hhd^Es, Ql, Re, Ql, Ql, Ql, Ql, Re, Ql, Ql, Hhd, Hhd, Ql, Rb, Rb, Hhd^Es, Rb^Fdw, Hhd^Es, Hhd^Fdw, Hhd^Esa, Hhd^Fdw, Ha^Fma, Ha^Fma, Ha^Esa, Ha^Esa, Hhd, Hhd, Ha^Fma, Ha^Fma, Ha^Fma, Hhd
Ha^Fpa, Ha^Fma, Ha, Cfa^Esa, Cfa^Esa, Cfa, Hhd, Ha^Esa, Hhd, Hhd^Fp, Hhd, Hhd^Es, Rb, Re, Qlf, Hhd, Hhd^Es, Hhd^Es, Ql, Ql, Hhd, Hhd, Re^Es, Re, Hhd, Hhd, Hhd, Ql, Ql, Qlf, Re, Rb, Rb, Hhd^Fdw, Ha^Fda, Ha^Fda, Ha^Fda, Ha^Fda, Ha^Fma, Ha, Aa^Fma, Ha^Fma, Ha^Fma, Ha^Fma, Ha^Fpa, Ha^Fma, Hhd
Ha^Fpa, Ha, Hhd^Esa, Ha^Esa, Ha, Hhd, Aa^Fpa, Aa^Fda, Ha^Fda, Hhd^Fp, Re^Es, Re^Es, Qlf, Ql, Re, Re, Hhd, Qlf, Qlf, Re, Rb, Re, Re, Re^Es, Re, Qlf, Hhd, Qlf, Qlf, Qlf, Rb, Re, Hhd^Fdw, Hhd^Fdw, Ha, Ha^Esa, Ha^Esa, Aa^Fma, Ha^Fpa, Aa^Fpa, Ha, Aa^Fpa, Aa^Fpa, Ha^Fpa, Ha^Fma, Ha^Fpa, Ha^Fpa
Aa, Hhd^Fp, Hhd^Fp, Ha^Fma, Ha^Esa, Ha^Esa, Aa^Fma, Ha^Fma, Ha^Fpa, Hhd, Re, Qlf, Qlf, Ql, Ql, Rb, Rb, Hhd, Hhd^Fdw, Rb, Rb, Re, Re, Hhd, Cf, Ql, Ql, Hhd, Hhd, Rb, Rb, Hhd^Es, Hhd, Hhd, Hhd^Fdw, Ha^Esa, Ha, Ha^Fma, Aa^Fma, Aa^Fpa, Aa^Fma, Ha^Fma, Ha^Esa, Ha^Fpa, Ha^Esa, Ha^Fma, Ha^Fpa
Ha^Fpa, Hhd^Fp, Aa^Fma, Aa^Fma, Aa^Fda, Aa^Fma, Aa^Fda, Aa^Fpa, Ha^Fpa, Ha^Esa, Hhd, Gd, Ql, Ql, Re^Es, Rb, Rb, Hhd^Fdw, Hhd^Fdw, Hhd, Hhd^Fmw, Re, Cf, Cf, Cf, Cf, Ql, Ql, Rb, Rb^Fdw, Qlf, Hhd^Es, Hhd^Es, Hhd^Es, Gd^Fdw, Hhd^Fdw, Aa^Fda, Aa^Fma, Aa^Fpa, Ha, Ha^Vca, Ha^Fpa, Aa^Fpa, Ha^Fpa, Ha^Fma, Ha^Fpa, Ha^Fma
Ha^Fpa, Ha^Fda, Ha^Fda, Aa^Fma, Aa^Fma, Aa^Fma, Ha^Vca, Aa^Fpa, Aa^Fda, Hhd, Gd^Fdw, Gd^Fdw, Qlf, Gd, Re^Es, Hhd^Fmw, Hhd^Fmw, Hhd, Ql, Re, Re, Re, Ql, 2 Kf, Ql, Cf, Ql, Hhd^Fdw, Hhd^Vhhr, Hhd, Re, Qlf, Qlf, Re^Es, Re^Es, Hhd^Fdw, Hhd, Ha^Fma, Aa^Fma, Aa^Fpa, Ha^Fpa, Ha^Fma, Ha^Fma, Ha^Fpa, Ha^Fpa, Ha^Fma, Ha^Fma
Ha^Fpa, Ha^Fpa, Ha^Fpa, Ha^Fpa, Ha^Fpa, Ha^Fpa, Ha^Fpa, Ha^Fpa, Hhd^Fp, Re, Re, Qlf, Rb^Fdw, Gd^Es, Hhd^Fmw, Hhd^Fmw, Hhd^Fmw, Hhd^Fmw, Qlf, Re, Gd, Ql, Rb, Ql, Hhd, Ql, Hhd, Hhd^Fdw, Hhd, Hhd, Gd, Qlf, Qlf, Re, Re^Es, Hhd^Fmw, Gll^Fmw, Aa^Fma, Hhd, Ha^Fma, Ha, Ha^Fpa, Ha^Fpa, Ha^Fpa, Ha^Fpa, Ha^Fma, Ha^Fma
Ha, Ha^Fpa, Hhd^Fp, Ha^Fpa, Ha^Fpa, Gd, Gd, Hhd^Fp, Gd, Hhd^Fp, Gd, Gd, Gd, Rb, Gd, Hhd^Fmw, Gd, Hhd^Fmw, Gd, Gd, Gd, Rb, Gd, Gd, Gd, Hhd, Gd, Hhd, Hhd, Hhd, Gd, Gd, Gd, Gd, Hhd, Hhd, Hhd, Hhd, Aa^Fma, Aa^Fma, Hhd, Aa^Fma, Ha, Ha^Fpa, Ha^Fpa, Ha, Ha
