Md^Xm, Aa, Md^Xm, Md^Xm, Md^Xm, Md^Xm, Md^Xm, Md^Xm, Md^Xm, Md^Xm, Md^Xm, Md^Xm, Md^Xm, Md^Xm, Md^Xm, Md^Xm, Md^Xm, Md^Xm, Md^Xm, Md^Xm, Md^Xm, Md^Xm, Md^Xm, Md^Xm, Md^Xm, Md^Xm, Md^Xm, Md^Xm, Md^Xm, Md^Xm, Md^Xm, Md^Xm, Md^Xm, Md^Xm, Md^Xm, Aa, Md^Xm, Md^Xm, Md^Xm, Md^Xm, Md^Xm, Md^Xm, Md^Xm, Md^Xm, Md^Xm, Md^Xm, Md^Xm
Md^Xm, Md^Xm, Md^Xm, Md^Xm, Md^Xm, Md^Xm, Md^Xm, Md^Xm, Md^Xm, Md^Xm, Md^Xm, Md^Xm, Md^Xm, Md^Xm, Md^Xm, Md^Xm, Md^Xm, Md^Xm, Md^Xm, Md^Xm, Md^Xm, Md^Xm, Md^Xm, Md^Xm, Md^Xm, Md^Xm, Md^Xm, Md^Xm, Md, Md^Xm, Md, Md^Xm, Md^Xm, Md^Xm, Md, Md^Xm, Md, Md^Xm, Md^Xm, Md^Xm, Md^Xm, Md^Xm, Md^Xm, Md^Xm, Md^Xm, Md^Xm, Md^Xm
Md^Xm, Md^Xm, Md^Xm, Md^Xm, Md^Xm, Md^Xm, Md^Xm, Md^Xm, Md^Xm, Md^Xm, Md^Xm, Md^Xm, Md^Xm, Md^Xm, Md^Xm, Md^Xm, Md^Xm, Md^Xm, Md^Xm, Md^Xm, Md, Md^Xm, Md, Md, Md, Md, Md, Md, Md, Md, Md, Md, Md, Md, Md, Md, Md, Md, Md^Xm, Md^Xm, Md^Xm, Md^Xm, Md^Xm, Md^Xm, Md^Xm, Md^Xm, Md^Xm
Md^Xm, Md^Xm, Md^Xm, Md^Xm, Md, Md^Xm, Md^Xm, Md^Xm, Md^Xm, Md, Md, Md, Md, Md, Md, Md, Md, Md, Md, Md, Hhd^Fp, Md, Md, Hhd^Fp, Hhd^Fp, Md, Md, Md, Md, Md, Hhd^Fp, Hhd^Fp, Md, Mv, Hhd^Fp, Md, Hhd, Md, Md, Md, Md^Xm, Md^Xm, Md^Xm, Md^Xm, Md^Xm, Md^Xm, Md^Xm
Md^Xm, Md^Xm, Md^Xm, Md^Xm, Md, Md, Md^Xm, Md^Xm, Md^Xm, Md, Md, Mv, Md, Hhd, Md, Md, Md, Md, Md, Hhd^Fp, Hhd^Fmw, Hhd^Fp, Hhd^Fp, Hhd, Hhd^Fmw, Hhd^Fp, Hhd^Fp, Mm^Xm, Hhd^Fp, Hhd^Fp, Gd^Fp, Hhd^Fp, Hhd, Md, Md, Hhd^Fp, Hhd^Fp, Md, Md, Md^Xm, Md^Xm, Md^Xm, Md^Xm, Md, Md, Md^Xm, Md^Xm
Md^Xm, Md^Xm, Md^Xm, Md, Md^Xm, Md, Md^Xm, Md^Xm, Md, Md^Xm, Md, Md, Hhd^Fp, Hhd, Hhd^Fp, Md, Hhd^Fp, Md, Hhd^Fp, Hhd^Fp, Hhd, Hhd^Fmw, Hhd^Fp, Gd^Fp, Gd^Fp, Hhd^Vhhr, Gd^Fmw, Hhd^Fmw, Hhd^Fdw, Hhd^Fdw, Hhd^Fdw, Hhd^Fp, Hhd^Fp, Md, Hhd^Fp, Hhd^Fp, Hhd^Fp, Md, Hhd^Fp, Md, Md, Md, Md, Md, Md^Xm, Md^Xm, Md^Xm
Md^Xm, Md^Xm, Md^Xm, Md^Xm, Md^Xm, Md, Md, Md^Xm, Md, Md, Hhd^Fp, Hhd^Fp, Hhd^Fp, Hhd^Fp, Hhd^Fmw, Hhd^Fp, Hhd^Fdw, Hhd^Fp, Re, Re, Re^Es, Gd^Fdw, Hhd^Fdw, Hhd^Fdw, Re^Es, Re, Re, Re, Gd, Re^Es, Gd^Fdw, Gd^Fp, Gd^Fp, Hhd^Fp, Hhd^Fmw, Hhd^Fp, Hhd^Fp, Hhd^Fp, Hhd^Fp, Md, Md, Md, Md^Xm, Md^Xm, Md^Xm, Md^Xm, Md^Xm
Md^Xm, Md^Xm, Md^Xm, Md^Xm, Md^Xm, Md^Xm, Md, Md, Md, Md, Md, Hhd^Fp, Hhd^Fmw, Hhd^Fp, Hhd^Fmw, Re^Fmw, Re, Hhd^Fdw, Gd, Gd, Rd, Gd, Re, Hhd^Fdw, Rd, Gd, Rd, Rd, Re, Rd, Hhd, Gd^Fdw, Gd^Fp, Hhd^Fp, Hhd^Fp, Hhd^Fp, Hhd^Fmw, Hhd^Fp, Hhd^Fp, Md, Md, Md, Md, Md^Xm, Md^Xm, Md^Xm, Md^Xm
Md^Xm, Md^Xm, Md^Xm, Md^Xm, Md^Xm, Md^Xm, Md, Md, Md, Md, Hhd^Fp, Hhd^Fp, Gd^Vhhr, Hhd^Fmw, Gd^Fp, Re^Fdw, Gd^Fdw, Gd^Es, Hhd, Gd, Re, Re, Re, Re^Es, Re, Gd^Es, Ql, Ql, Re, Rd, Hhd, Hhd^Fmw, Gd^Es, Gd^Fdw, Re^Fmw, Hhd^Fmw, Hhd^Fp, Hhd^Fmw, Hhd^Fp, Hhd^Fp, Md, Md, Md, Md^Xm, Md^Xm, Md^Xm, Md^Xm
Md^Xm, Md^Xm, Md, Md^Xm, Md^Xm, Md, Md, Md, Hhd, Hhd^Fp, Hhd, Hhd^Fp, Gd^Fmw, Hhd, Hhd^Fdw, Hhd^Fdw, Hhd, Hhd, Cte, Hhd, Ql, Rb, Rb, Rb, Ql, Re^Es, Re, Ql, Re, Hhd, Hhd, Hhd, Gd, Gd^Fdw, Re, Re, Hhd^Fmw, Hhd^Fmw, Hhd^Fp, Hhd^Fp, Md, Md, Md, Md^Xm, Md^Xm, Md^Xm, Md^Xm
Md^Xm, Md^Xm, Md, Md, Md, Md, Md, Mv, Md, Hhd^Fp, Hhd^Fmw, Hhd^Fmw, Hhd^Fdw, Hhd, Hhd, Hhd, Hhd, Cte, Kte, Cte, Ql, Qlf, Ql, Ql, Qlf, Rb^Es, Qlf, Re, Re, Hhd, Re, Rd, Rd, Gd, Gd, Re^Es, Re^Fmw, Gd^Fp, Hhd^Fp, Hhd^Fp, Hhd^Fp, Md, Hhd^Fp, Md, Md^Xm, Md^Xm, Md^Xm
Md^Xm, Md^Xm, Md^Xm, Md^Xm, Md^Xm, Md, Md, Md, Md, Hhd^Fp, Hhd^Fp, Hhd^Fdw, Hhd, Hhd, Rd, Rd, Hhd, Cte, Ql, Ql, Ql, Qxu, 1 Qxu, Qxu, Ql, Qlf, Qlf, Rb, Re, Re, Ql, Ql, Hhd, Re, Gd, Re, Re, Re, Hhd, Hhd^Fp, Hhd^Fp, Hhd^Fp, Hhd^Fp, Hhd^Fp, Md^Xm, Md^Xm, Md^Xm
Md^Xm, Md^Xm, Md^Xm, Md^Xm, Md^Xm, Md^Xm, Md, Mm^Xm, Md, Hhd, Hhd^Fp, Hhd^Fdw, Hhd, Gd, Gd^Fdw, Re^Es, Re^Es, Hhd, Ql, Ql, Ql, Qxu, Qxu, Ql, Ql, Qlf, Qlf, Qlf, Re, Hhd, Hhd, Hhd, Hhd, Gd, Re^Fdw, Re, Hhd, Hhd, Hhd, Hhd^Vhhr, Hhd, Hhd^Fp, Hhd^Fp, Md^Xm, Md^Xm, Md^Xm, Md^Xm
Md, Md, Md, Md^Xm, Md^Xm, Md^Xm, Md, Hhd, Hhd^Fp, Hhd, Hhd^Fdw, Hhd^Fdw, Gd, Gd^Fdw, Rd, Rb^Es, Re, Qlf, Qlf, Ql, Ql, Ql, Ql, Ql, Rr^Vd, Ql, Qlf, Rb, Rb^Es, Re, Hhd, Hhd, Hhd, Hhd, Gd^Fdw, Re^Fmw, Hhd^Fmw, Hhd, Hhd, Hhd^Fp, Hhd^Fp, Hhd^Fp, Md^Xm, Md^Xm, Md^Xm, Md^Xm, Md^Xm
Md, Md, Md, Md, Md^Xm, Md^Xm, Md^Xm, Hhd^Fp, Mm^Xm, Mm^Xm, Hhd^Fdw, Hhd, Gd, Ql, Rd, Rd, Re, Re, Qlf, Ql, Ql, Ql, Ql, Ql, Ql, Qlf, Qlf, Qlf, Re, Re^Es, Qlf, Qlf, Hhd, Gd^Fdw, Gd^Fdw, Re^Fdw, Re^Fmw, Hhd, Hhd^Fmw, Hhd^Fmw, Hhd^Fp, Hhd^Fp, Md, Md^Xm, Md^Xm, Md^Xm, Md^Xm
Md, Md, Md, Md, Md, Md^Xm, Md^Xm, Hhd, Hhd^Fp, Mm^Xm, Gd^Fmw, Gd^Fmw, Gd, Ql, Gd, Rr^Vd, Hhd, Re, Rb, Qlf, Qlf, Ql, Qlf, Ql, Qlf, Qlf, Qlf, Rb, Re, Qlf, Ql, Qlf, Hhd, Gd, Gd, Gd^Fdw, Gd^Fmw, Gd^Fmw, Hhd^Fmw, Hhd^Fmw, Hhd^Fp, Hhd^Fp, Md, Md^Xm, Md^Xm, Md^Xm, Md^Xm
Hhd, Md, Md, Md, Md, Md^Xm, Md^Xm, Hhd^Fp, Md^Xm, Hhd^Fp, Hhd^Fp, Gd^Fmw, Gd^Fmw, Gd, Gd, Ql, Gd, Gd, Rb^Es, Qlf, Qlf, Qlf, Qlf, Qlf, Qlf, Qlf, Qlf, Rb, Re, Rb, Hhd, Hhd, Hhd, Re, Ql, Rd, Hhd^Fmw, Hhd^Fmw, Hhd^Fmw, Hhd^Fmw, Hhd^Fp, Md, Md, Md^Xm, Md^Xm, Md^Xm, Md^Xm
Hhd, Hhd^Fp, Md, Hhd^Fp, Hhd^Fp, Md, Md, Md^Xm, Md, Md, Gd^Fp, Hhd^Fp, Gd^Fmw, Gd, Hhd, Gd, Rd, Gd, Re, Re^Es, Re, Rb, Qlf, Qlf, Rb, Qlf, Rb, Qlf, Re, Re, Hhd, Hhd, Re, Ql, Rd, Rd, Rd^Fmw, Hhd^Fmw, Hhd^Fp, Hhd^Fmw, Md, Mv, Md, Md^Xm, Md^Xm, Md^Xm, Md^Xm
Hhd, Hhd, Hhd, Hhd, Hhd^Fp, Hhd^Fp, Hhd, Md, Gd^Fp, Md, Gd^Fmw, Gd^Fp, Rb, Rb, Ql, Hhd, Hhd, Rd, Rd, Re^Es, Re, Re, Re, Qlf, Rb^Es, Rb, Re, Rb, Re, Re, Re, Rd, Rd, Rd, Rd, Rd^Fmw, Hhd^Fmw, Hhd^Fmw, Hhd^Fp, Hhd^Vhhr, Md^Xm, Md, Md^Xm, Md, Md^Xm, Md^Xm, Md^Xm
Md, Md, Md, Hhd, Hhd, Hhd, Hhd, Hhd, Hhd^Fp, Gd^Fmw, Gd^Fp, Hhd, Rb, Ql, Ql, Hhd, Hhd, Re, Rd, Re, Re, Re, Re, Re, Re^Es, Re, Hhd, Rb, Hhd, Hhd, Re, Rd, Rd, Hhd^Fdw, Hhd, Hhd, Mm^Xm, Mm^Xm, Mm^Xm, Hhd^Fp, Md^Xm, Md^Xm, Hhd^Fp, Md^Xm, Hhd^Fp, Md^Xm, Hhd^Fp
Md, Md, Md, Hhd, Hhd^Fp, Hhd^Fp, Hhd, Hhd, Hhd^Fp, Hhd, Hhd, Hhd, Hhd, Rb, Qlf, Hhd, Qlf, Ql, Re, Re, Re, Re^Es, Qlf, Hhd, Hhd, Hhd, Hhd, Re, Gd, Qlf, Qlf, Rd, Hhd^Fdw, Hhd^Fdw, Hhd^Fdw, Hhd, Md, Md, Md, Hhd^Fp, Hhd^Fp, Md^Xm, Hhd^Fp, Hhd^Fp, Hhd^Fp, Hhd^Fp, Aa^Fp
Md^Xm, Md, Md, Md, Md, Md, Md, Md, Md, Hhd^Fp, Hhd, Hhd, Hhd, Hhd, Hhd, Qlf, Hhd, Ql, Hhd, Re, Re, Re, Rd, Ql, Hhd, Hhd, Qlf, Gd, Gd, Re, Re, Gd, Hhd, Hhd, Hhd, Hhd^Fp, Hhd^Fdw, Hhd^Fp, Hhd^Fdw, Hhd^Fp, Hhd^Fp, Hhd^Fp, Hhd^Fp, Hhd^Fp, Hhd^Fp, Hhd^Fp, Hhd^Fp
Md^Xm, Md^Xm, Md^Xm, Md^Xm, Md^Xm, Md, Md^Xm, Md, Md, Hhd^Fp, Md, Hhd^Fp, Hhd, Hhd^Fp, Hhd^Fp, Hhd^Fmw, Hhd^Fp, Hhd, Gd, Gd, Re, Rd, Rd, Ql, Ql, Ql, Gd, Gd, Gd, Re, Re, Rd, Hhd, Hhd, Hhd^Fdw, Hhd^Fdw, Ql, Qlf, Qlf, Hhd^Fp, Hhd^Fmw, Hhd^Fp, Hhd^Fp, Hhd^Fp, Hhd^Fp, Hhd^Fp, Hhd^Fp
Md^Xm, Md^Xm, Md^Xm, Md^Xm, Md, Md, Md, Md^Xm, Md, Mv, Md, Md, Md, Hhd^Fp, Gd^Fp, Hhd^Fmw, Re^Fmw, Hhd, Gd^Es, Gd, Gd, Rd, Gd, Rd, Re, Qlf, Qlf, Gd^Es, Gd^Es, Gd, Hhd, Re, Hhd, Hhd, Hhd, Re^Es, Ql, Ql, Qlf, Gd^Fdw, Hhd^Fdw, Hhd^Fp, Hhd^Fdw, Hhd^Fp, Hhd^Fp, Gd^Fp, Gd^Fp
Md^Xm, Md^Xm, Md^Xm, Md, Hhd^Fp, Hhd^Fp, Hhd^Fp, Md^Xm, Hhd^Fp, Md, Md, Md, Hhd^Fp, Hhd^Fp, Hhd^Fmw, Rb^Fmw, Rb^Fdw, Re^Fdw, Re, Gd, Gd, Gd, Gd, Rb, Rb, Re, Gd, Gd, Gd^Es, Hhd, Hhd, Hhd, Hhd, Hhd, Re^Es, Re^Es, Gd, Qlf, Gd^Fdw, Gd^Fdw, Hhd^Vhhr, Gd^Fp, Hhd^Fdw, Hhd^Fp, Hhd^Fdw, Hhd^Fmw, Gd^Fp
Md^Xm, Md^Xm, Md^Xm, Md, Md, Hhd^Fp, Hhd^Fp, Hhd^Vhhr, Rb, Md^Fmw, Md, Md, Hhd, Hhd, Hhd^Fp, Rb^Fdw, Rb, Re^Fdw, Gd, Gd, Gd, Gd, Hhd^Fdw, Hhd, Hhd, Gd, Ql, Gd, Gd, Qlf, Gd, Re, Hhd, Hhd, Re, Re^Es, Gd, Gd, Ql, Gd^Fp, Re, Hhd, Hhd, Hhd^Fdw, Hhd^Fdw, Hhd^Fdw, Gd^Fp
Hhd^Fp, Md^Xm, Md^Xm, Md^Xm, Md^Xm, Hhd^Fmw, Hhd, Hhd, Qlf, Rb^Es, Hhd, Hhd, Rb, Rb, Re, Hhd, Rb, Re, Re, Gd, Re, Re^Fdw, Qlf, Qlf, Hhd^Vhhr, Hhd, Hhd, Ql, Re, Re, Hhd^Fdw, Re, Re, Hhd, Re, Re, Gd, Gd, Re, Gd, Re^Es, Re^Es, Hhd^Fdw, Hhd^Fdw, Hhd^Fdw, Gll^Fp, Gd^Fp
Hhd^Fp, Hhd^Fp, Hhd^Fmw, Mm^Fmw, Hhd^Fp, Md^Xm, Hhd, Rb, Qlf, Qlf, Hhd, Hhd, Rb, Hhd, Hhd, Re, Gd^Es, Re, Re, Re, Re, Re^Fdw, Re, Ql, Ql, Hhd, Hhd, Re, Re, Qlf, Qlf, Gd^Fdw, Gd, Re, Re, Gd, Gd^Es, Gd^Es, Hhd, Re, Re^Es, Hhd, Hhd, Hhd, Hhd, Hhd^Fdw, Hhd
Hhd^Fmw, Hhd^Fmw, Hhd^Fmw, Hhd^Fmw, Hhd^Fp, Rb, Ql, Qlf, Rb, Qlf, Hhd, Hhd, Re, Re, Hhd, Re, Re^Es, Re^Es, Rb, Rb, Rb, Re, Ql, Re, Ql, Ql, Rb, Re, Ql, Ql, Gd, Gd, Re, Re, Re, Re, Re, Re^Es, Hhd, Hhd^Es, Hhd^Es, Hhd, Hhd, Cf, Hhd, Hhd^Fdw, Rb
Hhd, Hhd, Hhd^Fmw, Hhd^Fmw, Rb^Es, Rb^Es, Ql, Rb, Hhd, Hhd, Hhd, Hhd, Hhd, Hhd, Hhd, Hhd, Re, Rb, Qlf, Qlf, Rb^Es, Qlf, Rb, Re, Gd^Es, Ql, Gd, Rb, Gd, Ql, Ql, Re, Re, Re, Hhd, Re, Re, Hhd, Hhd, Hhd, Hhd, Cf, Cf, Cf, Hhd, Hhd^Fdw, Hhd
Gd^Fmw, Hhd^Vhhr, Hhd^Fdw, Hhd^Fmw, Re, Re, Hhd, Ql, Re, Hhd, Hhd, Hhd, Hhd, Hhd, Hhd, Hhd, Hhd, Ql, Hhd^Fdw, Rb, Hhd^Fdw, Rb^Es, Qlf, Qlf, Re, Gd^Es, Re^Fdw, Rb^Fdw, Gd, Ql, Rb, Re, Re^Fdw, Re^Fdw, Hhd, Hhd, Hhd, Re, Hhd, Hhd, Hhd, Cf, 3 Kf, Hhd, Hhd, Hhd, Hhd
Hhd, Hhd^Fmw, Hhd^Fmw, Hhd, Cf, Qlf, Hhd, Hhd, Re, Hhd, Hhd, Re, Hhd, Hhd^Fdw, Hhd, Hhd^Fdw, Hhd^Fdw, Ql, Ql, Hhd^Fdw, Hhd, Ql, Ql, Ql, Ql, Hhd, Hhd^Fdw, Hhd^Fdw, Rb, Qlf, Rb, Rb, Rb, Re, Hhd, Hhd^Fdw, Hhd^Fdw, Hhd, Hhd, Hhd, Hhd, Hhd, Hhd^Fmw, Hhd, Hhd^Vhhr, Hhd, Hhd^Fmw
Hhd^Fmw, Hhd, Hhd, Cf, 4 Kf, Hhd, Hhd, Hhd, Hhd, Hhd, Hhd, Hhd, Re^Fdw, Re^Fdw, Hhd^Fdw, Hhd, Hhd, Ql, Re, Ql, Ql, Ql, Ql, Re, Ql, Ql, Hhd, Hhd, Ql, Rb, Rb, Hhd^Es, Rb^Fdw, Hhd^Es, Hhd^Fdw, Hhd, Hhd^Fdw, Hhd^Fmw, Hhd^Fmw, Hhd, Hhd, Hhd, Hhd, Hhd^Fmw, Hhd^Fmw, Hhd^Fmw, Hhd
Hhd^Fp, Hhd^Fmw, Hhd, Cf, Cf, Cf, Hhd, Hhd, Hhd, Hhd^Fp, Hhd, Hhd, Rb, Re, Qlf, Hhd, Hhd, Hhd, Ql, Ql, Hhd, Hhd, Re^Es, Re, Hhd, Hhd, Hhd, Ql, Ql, Qlf, Re, Rb, Rb, Hhd^Fdw, Hhd^Fdw, Hhd^Fdw, Hhd^Fdw, Hhd^Fdw, Hhd^Fmw, Hhd, Gll^Fmw, Hhd^Fmw, Hhd^Fmw, Hhd^Fmw, Hhd^Fp, Hhd^Fmw, Hhd
Hhd^Fp, Hhd, Hhd, Hhd, Hhd, Hhd, Gd^Fp, Gd^Fdw, Hhd^Fdw, Hhd^Fp, Re^Es, Re^Es, Qlf, Ql, Re, Re, Hhd, Qlf, Qlf, Re, Rb, Re, Re, Re^Es, Re, Qlf, Hhd, Qlf, Qlf, Qlf, Rb, Re, Hhd^Fdw, Hhd^Fdw, Hhd, Hhd, Hhd, Gll^Fmw, Hhd^Fp, Gll^Fp, Hhd, Gll^Fp, Gll^Fp, Hhd^Fp, Hhd^Fmw, Hhd^Fp, Hhd^Fp
Gd, Hhd^Fp, Hhd^Fp, Hhd^Fmw, Hhd, Hhd, Gd^Fmw, Hhd^Fmw, Hhd^Fp, Hhd, Re, Qlf, Qlf, Ql, Ql, Rb, Rb, Hhd, Hhd^Fdw, Rb, Rb, Re, Re, Hhd, Cf, Ql, Ql, Hhd, Hhd, Rb, Rb, Hhd^Es, Hhd, Hhd, Hhd^Fdw, Hhd, Hhd, Hhd^Fmw, Gll^Fmw, Gll^Fp, Gll^Fmw, Hhd^Fmw, Hhd, Hhd^Fp, Hhd, Hhd^Fmw, Hhd^Fp
Hhd^Fp, Hhd^Fp, Gd^Fmw, Gd^Fmw, Gd^Fdw, Gd^Fmw, Gd^Fdw, Gd^Fp, Hhd^Fp, Hhd, Hhd, Gd, Ql, Ql, Re^Es, Rb, Rb, Hhd^Fdw, Hhd^Fdw, Hhd, Hhd^Fmw, Re, Cf, Cf, Cf, Cf, Ql, Ql, Rb, Rb^Fdw, Qlf, Hhd^Es, Hhd^Es, Hhd^Es, Gd^Fdw, Hhd^Fdw, Gd^Fdw, Gll^Fmw, Gll^Fp, Hhd, Hhd^Vhhr, Hhd^Fp, Gll^Fp, Hhd^Fp, Hhd^Fmw, Hhd^Fp, Hhd^Fmw
Hhd^Fp, Hhd^Fdw, Hhd^Fdw, Gd^Fmw, Gd^Fmw, Gd^Fmw, Hhd^Vhhr, Gd^Fp, Gd^Fdw, Hhd, Gd^Fdw, Gd^Fdw, Qlf, Gd, Re^Es, Hhd^Fmw, Hhd^Fmw, Hhd, Ql, Re, Re, Re, Ql, 2 Kf, Ql, Cf, Ql, Hhd^Fdw, Hhd^Vhhr, Hhd, Re, Qlf, Qlf, Re^Es, Re^Es, Hhd^Fdw, Hhd, Hhd^Fmw, Gll^Fmw, Gll^Fp, Hhd^Fp, Hhd^Fmw, Hhd^Fmw, Hhd^Fp, Hhd^Fp, Hhd^Fmw, Gll^Fmw
Hhd^Fp, Hhd^Fp, Hhd^Fp, Hhd^Fp, Hhd^Fp, Hhd^Fp, Hhd^Fp, Hhd^Fp, Hhd^Fp, Re, Re, Qlf, Rb^Fdw, Gd^Es, Hhd^Fmw, Hhd^Fmw, Hhd^Fmw, Hhd^Fmw, Qlf, Re, Gd, Ql, Rb, Ql, Hhd, Ql, Hhd, Hhd^Fdw, Hhd, Hhd, Gd, Qlf, Qlf, Re, Re^Es, Hhd^Fmw, Gll^Fmw, Gll^Fmw, Hhd, Hhd^Fmw, Hhd, Hhd^Fp, Hhd^Fp, Hhd^Fp, Hhd^Fp, Hhd^Fmw, Hhd^Fmw
Gd, Hhd^Fp, Hhd^Fp, Hhd^Fp, Hhd^Fp, Gd, Gd, Hhd^Fp, Gd, Hhd^Fp, Gd, Gd, Gd, Rb, Gd, Hhd^Fmw, Gd, Hhd^Fmw, Gd, Gd, Gd, Rb, Gd, Gd, Gd, Hhd, Gd, Hhd, Hhd, Hhd, Gd, Gd, Gd, Gd, Hhd, Hhd, Hhd, Hhd, Gll^Fmw, Hhd^Fmw, Hhd, Gll^Fmw, Hhd, Hhd^Fp, Hhd^Fp, Hhd, Hhd
