Ms^Xm, Aa, Ms^Xm, Ms^Xm, Ms^Xm, Ms^Xm, Ms^Xm, Ms^Xm, Ms^Xm, Ms^Xm, Ms^Xm, Ms^Xm, Ms^Xm, Ms^Xm, Ms^Xm, Ms^Xm, Ms^Xm, Ms^Xm, Ms^Xm, Ms^Xm, Ms^Xm, Ms^Xm, Ms^Xm, Ms^Xm, Ms^Xm, Ms^Xm, Ms^Xm, Ms^Xm, Ms^Xm, Ms^Xm, Ms^Xm, Ms^Xm, Ms^Xm, Ms^Xm, Ms^Xm, Aa, Ms^Xm, Ms^Xm, Ms^Xm, Ms^Xm, Ms^Xm, Ms^Xm, Ms^Xm, Ms^Xm, Ms^Xm, Ms^Xm, Ms^Xm
Ms^Xm, Ms^Xm, Ms^Xm, Ms^Xm, Ms^Xm, Ms^Xm, Ms^Xm, Ms^Xm, Ms^Xm, Ms^Xm, Ms^Xm, Ms^Xm, Ms^Xm, Ms^Xm, Ms^Xm, Ms^Xm, Ms^Xm, Ms^Xm, Ms^Xm, Ms^Xm, Ms^Xm, Ms^Xm, Ms^Xm, Ms^Xm, Ms^Xm, Ms^Xm, Ms^Xm, Ms^Xm, Ms, Ms^Xm, Ms, Ms^Xm, Ms^Xm, Ms^Xm, Ms, Ms^Xm, Ms, Ms^Xm, Ms^Xm, Ms^Xm, Ms^Xm, Ms^Xm, Ms^Xm, Ms^Xm, Ms^Xm, Ms^Xm, Ms^Xm
Ms^Xm, Ms^Xm, Ms^Xm, Ms^Xm, Ms^Xm, Ms^Xm, Ms^Xm, Ms^Xm, Ms^Xm, Ms^Xm, Ms^Xm, Ms^Xm, Ms^Xm, Ms^Xm, Ms^Xm, Ms^Xm, Ms^Xm, Ms^Xm, Ms^Xm, Ms^Xm, Ms, Ms^Xm, Ms, Ms, Ms, Ms, Ms, Ms, Ms, Ms, Ms, Ms, Ms, Ms, Ms, Ms, Ms, Ms, Ms^Xm, Ms^Xm, Ms^Xm, Ms^Xm, Ms^Xm, Ms^Xm, Ms^Xm, Ms^Xm, Ms^Xm
Ms^Xm, Ms^Xm, Ms^Xm, Ms^Xm, Ms, Ms^Xm, Ms^Xm, Ms^Xm, Ms^Xm, Ms, Ms, Ms, Ms, Ms, Ms, Ms, Ms, Ms, Ms, Ms, Ha^Fp, Ms, Ms, Ha^Fp, Ha^Fp, Ms, Ms, Ms, Ms, Ms, Ha^Fp, Ha^Fp, Md, Mv, Md, Ms, Ha, Ms, Ms, Ms, Ms^Xm, Ms^Xm, Ms^Xm, Ms^Xm, Ms^Xm, Ms^Xm, Ms^Xm
Ms^Xm, Ms^Xm, Ms^Xm, Ms^Xm, Ms, Ms, Ms^Xm, Ms^Xm, Ms^Xm, Ms, Md, Mv, Md, Ha, Ms, Ms, Ms, Ms, Ms, Ha^Fp, Ha^Fmw, Ha^Fp, Ha^Fp, Ha, Ha^Fmw, Ha^Fp, Hhd^Fp, Mm^Xm, Ha^Fp, Ha^Fp, Gd^Fp, Ha^Fp, Ha, Md, Ms, Ha^Fp, Ha^Fp, Ms, Ms, Ms^Xm, Ms^Xm, Ms^Xm, Ms^Xm, Ms, Ms, Ms^Xm, Ms^Xm
Ms^Xm, Ms^Xm, Ms^Xm, Ms, Ms^Xm, Ms, Ms^Xm, Ms^Xm, Ms, Ms^Xm, Ms, Md, Ha^Fp, Ha, Ha^Fp, Ms, Ha^Fp, Ms, Ha^Fp, Ha^Fp, Ha, Ha^Fmw, Ha^Fp, Aa^Fp, Gd^Fp, Hhd^Vhhr, Gd^Fmw, Hhd^Fmw, Ha^Fdw, Ha^Fdw, Hhd^Fdw, Hhd^Fp, Ha^Fp, Ms, Ha^Fp, Ha^Fp, Ha^Fp, Ms, Ha^Fp, Ms, Ms, Ms, Ms, Ms, Ms^Xm, Ms^Xm, Ms^Xm
Ms^Xm, Ms^Xm, Ms^Xm, Ms^Xm, Ms^Xm, Ms, Ms, Ms^Xm, Ms, Ms, Ha^Fp, Ha^Fp, Ha^Fp, Ha^Fp, Ha^Fmw, Ha^Fp, Ha^Fdw, Ha^Fp, Re, Re, Re^Es, Aa^Fdw, Hhd^Fdw, Hhd^Fdw, Re^Es, Re, Re, Re, Gd, Re^Es, Aa^Fdw, Aa^Fp, Aa^Fp, Ha^Fp, Ha^Fmw, Ha^Fp, Hhd^Fp, Ha^Fp, Ha^Fp, Ms, Ms, Ms, Ms^Xm, Ms^Xm, Ms^Xm, Ms^Xm, Ms^Xm
Ms^Xm, Ms^Xm, Ms^Xm, Ms^Xm, Ms^Xm, Ms^Xm, Ms, Ms, Ms, Ms, Ms, Ha^Fp, Ha^Fmw, Ha^Fp, Hhd^Fmw, Aa^Fmw, Re, Ha^Fdw, Gd, Gd, Rd, Gd, Re, Hhd^Fdw, Rd, Gd, Rd, Rd, Re, Rd, Hhd, Aa^Fdw, Gd^Fp, Ha^Fp, Hhd^Fp, Hhd^Fp, Hhd^Fmw, Ha^Fp, Ha^Fp, Ms, Ms, Ms, Ms, Ms^Xm, Ms^Xm, Ms^Xm, Ms^Xm
Ms^Xm, Ms^Xm, Ms^Xm, Ms^Xm, Ms^Xm, Ms^Xm, Ms, Ms, Ms, Ms, Ha^Fp, Ha^Fp, Aa^Vhhr, Ha^Fmw, Aa^Fp, Re^Fdw, Gd^Fdw, Gd^Es, Hhd, Gd, Re, Re, Re, Re^Es, Re, Gd^Es, Ql, Ql, Re, Rd, Hhd, Hhd^Fmw, Gd^Es, Gd^Fdw, Re^Fmw, Hhd^Fmw, Ha^Fp, Ha^Fmw, Ha^Fp, Hhd^Fp, Ms, Ms, Ms, Ms^Xm, Ms^Xm, Ms^Xm, Ms^Xm
Ms^Xm, Ms^Xm, Ms, Ms^Xm, Ms^Xm, Ms, Ms, Ms, Ha, Ha^Fp, Ha, Ha^Fp, Aa^Fmw, Ha, Ha^Fdw, Hhd^Fdw, Hhd, Hhd, Cte, Hhd, Ql, Rb, Rb, Rb, Ql, Re^Es, Re, Ql, Re, Hhd, Hhd, Hhd, Gd, Gd^Fdw, Re, Re, Hhd^Fmw, Ha^Fmw, Hhd^Fp, Hhd^Fp, Ms, Ms, Ms, Ms^Xm, Ms^Xm, Ms^Xm, Ms^Xm
Ms^Xm, Ms^Xm, Ms, Ms, Ms, Ms, Md, Mv, Md, Ha^Fp, Ha^Fmw, Ha^Fmw, Hhd^Fdw, Ha, Hhd, Hhd, Hhd, Cte, Kte, Cte, Ql, Qlf, Ql, Ql, Qlf, Rb^Es, Qlf, Re, Re, Hhd, Re, Rd, Rd, Gd, Gd, Re^Es, Re^Fmw, Gd^Fp, Hhd^Fp, Ha^Fp, Ha^Fp, Ms, Ha^Fp, Ms, Ms^Xm, Ms^Xm, Ms^Xm
Ms^Xm, Ms^Xm, Ms^Xm, Ms^Xm, Ms^Xm, Ms, Ms, Md, Ms, Ha^Fp, Ha^Fp, Ha^Fdw, Hhd, Hhd, Rd, Rd, Hhd, Cte, Ql, Ql, Ql, Qxu, 1 Qxu, Qxu, Ql, Qlf, Qlf, Rb, Re, Re, Ql, Ql, Hhd, Re, Gd, Re, Re, Re, Ha, Ha^Fp, Ha^Fp, Ha^Fp, Ha^Fp, Ha^Fp, Ms^Xm, Ms^Xm, Ms^Xm
Ms^Xm, Ms^Xm, Ms^Xm, Ms^Xm, Ms^Xm, Ms^Xm, Ms, Ms^Xm, Ms, Ha, Ha^Fp, Hhd^Fdw, Hhd, Gd, Gd^Fdw, Re^Es, Re^Es, Hhd, Ql, Ql, Ql, Qxu, Qxu, Ql, Ql, Qlf, Qlf, Qlf, Re, Hhd, Hhd, Hhd, Hhd, Gd, Re^Fdw, Re, Hhd, Hhd, Ha, Ha^Vhhr, Ha, Ha^Fp, Ha^Fp, Ms^Xm, Ms^Xm, Ms^Xm, Ms^Xm
Ms, Ms, Ms, Ms^Xm, Ms^Xm, Ms^Xm, Ms, Ha, Ha^Fp, Ha, Hhd^Fdw, Hhd^Fdw, Gd, Gd^Fdw, Rd, Rb^Es, Re, Qlf, Qlf, Ql, Ql, Ql, Ql, Ql, Rr^Vd, Ql, Qlf, Rb, Rb^Es, Re, Hhd, Hhd, Hhd, Hhd, Gd^Fdw, Re^Fmw, Hhd^Fmw, Hhd, Hhd, Hhd^Fp, Ha^Fp, Ha^Fp, Ms^Xm, Ms^Xm, Ms^Xm, Ms^Xm, Ms^Xm
Ms, Ms, Ms, Ms, Ms^Xm, Ms^Xm, Ms^Xm, Ha^Fp, Ms^Xm, Ms^Xm, Hhd^Fdw, Hhd, Gd, Ql, Rd, Rd, Re, Re, Qlf, Ql, Ql, Ql, Ql, Ql, Ql, Qlf, Qlf, Qlf, Re, Re^Es, Qlf, Qlf, Hhd, Gd^Fdw, Gd^Fdw, Re^Fdw, Re^Fmw, Hhd, Hhd^Fmw, Hhd^Fmw, Ha^Fp, Ha^Fp, Ms, Ms^Xm, Ms^Xm, Ms^Xm, Ms^Xm
Ms, Ms, Ms, Ms, Ms, Ms^Xm, Ms^Xm, Ha, Ha^Fp, Ms^Xm, Aa^Fmw, Aa^Fmw, Gd, Ql, Gd, Rr^Vd, Hhd, Re, Rb, Qlf, Qlf, Ql, Qlf, Ql, Qlf, Qlf, Qlf, Rb, Re, Qlf, Ql, Qlf, Hhd, Gd, Gd, Gd^Fdw, Gd^Fmw, Gd^Fmw, Hhd^Fmw, Ha^Fmw, Ha^Fp, Ha^Fp, Ms, Ms^Xm, Ms^Xm, Ms^Xm, Ms^Xm
Ha, Ms, Ms, Ms, Ms, Ms^Xm, Ms^Xm, Ha^Fp, Ms^Xm, Ha^Fp, Ha^Fp, Aa^Fmw, Aa^Fmw, Gd, Gd, Ql, Gd, Gd, Rb^Es, Qlf, Qlf, Qlf, Qlf, Qlf, Qlf, Qlf, Qlf, Rb, Re, Rb, Hhd, Hhd, Hhd, Re, Ql, Rd, Hhd^Fmw, Hhd^Fmw, Ha^Fmw, Ha^Fmw, Ha^Fp, Ms, Ms, Ms^Xm, Ms^Xm, Ms^Xm, Ms^Xm
Ha, Ha^Fp, Ms, Ha^Fp, Ha^Fp, Ms, Ms, Ms^Xm, Ms, Ms, Aa^Fp, Ha^Fp, Gd^Fmw, Gd, Hhd, Gd, Rd, Gd, Re, Re^Es, Re, Rb, Qlf, Qlf, Rb, Qlf, Rb, Qlf, Re, Re, Hhd, Hhd, Re, Ql, Rd, Rd, Rd^Fmw, Ha^Fmw, Ha^Fp, Ha^Fmw, Md, Mv, Md, Ms^Xm, Ms^Xm, Ms^Xm, Ms^Xm
Ha, Ha, Ha, Ha, Ha^Fp, Ha^Fp, Ha, Ms, Aa^Fp, Ms, Aa^Fmw, Aa^Fp, Rb, Rb, Ql, Hhd, Hhd, Rd, Rd, Re^Es, Re, Re, Re, Qlf, Rb^Es, Rb, Re, Rb, Re, Re, Re, Rd, Rd, Rd, Rd, Rd^Fmw, Aa^Fmw, Ha^Fmw, Ha^Fpa, Ha^Vhhr, Ms^Xm, Md, Ms^Xm, Ms, Ms^Xm, Ms^Xm, Ms^Xm
Ms, Ms, Ms, Ha, Ha, Ha, Ha, Ha, Ha^Fp, Aa^Fmw, Gd^Fp, Hhd, Rb, Ql, Ql, Hhd, Hhd, Re, Rd, Re, Re, Re, Re, Re, Re^Es, Re, Hhd, Rb, Hhd, Hhd, Re, Rd, Rd, Hhd^Fdw, Hhd, Hhd, Ms^Xm, Ms^Xm, Ms^Xm, Ha^Fpa, Ms^Xm, Ms^Xm, Ha^Fpa, Ms^Xm, Ha^Fpa, Ms^Xm, Ha^Fpa
Ms, Ms, Ms, Ha, Ha^Fp, Ha^Fp, Ha, Ha, Ha^Fp, Hhd, Ha, Hhd, Hhd, Rb, Qlf, Hhd, Qlf, Ql, Re, Re, Re, Re^Es, Qlf, Hhd, Hhd, Hhd, Hhd, Re, Gd, Qlf, Qlf, Rd, Hhd^Fdw, Hhd^Fdw, Ha^Fdw, Ha, Ms, Ms, Ms, Ha^Fpa, Ha^Fpa, Ms^Xm, Ha^Fpa, Ha^Fpa, Ha^Fpa, Ha^Fpa, Aa^Fpa
Ms^Xm, Ms, Ms, Ms, Ms, Ms, Ms, Ms, Ms, Ha^Fp, Ha, Ha, Hhd, Hhd, Hhd, Qlf, Hhd, Ql, Hhd, Re, Re, Re, Rd, Ql, Hhd, Hhd, Qlf, Gd, Gd, Re, Re, Gd, Hhd, Hhd, Hhd, Ha^Fp, Hhd^Fdw, Hhd^Fp, Hhd^Fdw, Hhd^Fp, Ha^Fpa, Ha^Fpa, Ha^Fpa, Ha^Fpa, Ha^Fpa, Ha^Fpa, Ha^Fpa
Ms^Xm, Ms^Xm, Ms^Xm, Ms^Xm, Ms^Xm, Ms, Ms^Xm, Ms, Ms, Ha^Fp, Ms, Ha^Fp, Ha, Hhd^Fp, Hhd^Fp, Hhd^Fmw, Hhd^Fp, Hhd, Gd, Gd, Re, Rd, Rd, Ql, Ql, Ql, Gd, Gd, Gd, Re, Re, Rd, Hhd, Hhd, Hhd^Fdw, Hhd^Fdw, Ql, Qlf, Qlf, Hhd^Fp, Hhd^Fmw, Hhd^Fp, Ha^Fpa, Ha^Fpa, Ha^Fpa, Ha^Fpa, Ha^Fpa
Ms^Xm, Ms^Xm, Ms^Xm, Ms^Xm, Ms, Ms, Ms, Ms^Xm, Md, Mv, Md, Ms, Ms, Ha^Fp, Gd^Fp, Hhd^Fmw, Re^Fmw, Hhd, Gd^Es, Gd, Gd, Rd, Gd, Rd, Re, Qlf, Qlf, Gd^Es, Gd^Es, Gd, Hhd, Re, Hhd, Hhd, Hhd, Re^Es, Ql, Ql, Qlf, Gd^Fdw, Hhd^Fdw, Hhd^Fp, Hhd^Fdw, Ha^Fpa, Hhd^Fp, Aa^Fpa, Aa^Fpa
Ms^Xm, Ms^Xm, Ms^Xm, Ms, Ha^Fp, Ha^Fp, Ha^Fp, Ms^Xm, Ha^Fp, Md, Ms, Ms, Ha^Fp, Ha^Fp, Hhd^Fmw, Rb^Fmw, Rb^Fdw, Re^Fdw, Re, Gd, Gd, Gd, Gd, Rb, Rb, Re, Gd, Gd, Gd^Es, Hhd, Hhd, Hhd, Hhd, Hhd, Re^Es, Re^Es, Gd, Qlf, Gd^Fdw, Gd^Fdw, Hhd^Vhhr, Gd^Fp, Hhd^Fdw, Hhd^Fp, Ha^Fdw, Hhd^Fmw, Gd^Fp
Ms^Xm, Ms^Xm, Ms^Xm, Ms, Ms, Ha^Fp, Ha^Fp, Ha^Vhhr, Rb, Ms, Ms, Ms, Hhd, Hhd, Hhd^Fp, Rb^Fdw, Rb, Re^Fdw, Gd, Gd, Gd, Gd, Hhd^Fdw, Hhd, Hhd, Gd, Ql, Gd, Gd, Qlf, Gd, Re, Hhd, Hhd, Re, Re^Es, Gd, Gd, Ql, Gd^Fp, Re, Hhd, Hhd, Hhd^Fdw, Ha^Fdw, Ha^Fdw, Aa^Fpa
Ha^Fp, Ms^Xm, Ms^Xm, Ms^Xm, Ms^Xm, Ha^Fmw, Hhd, Hhd, Qlf, Rb^Es, Hhd, Hhd, Rb, Rb, Re, Hhd, Rb, Re, Re, Gd, Re, Re^Fdw, Qlf, Qlf, Hhd^Vhhr, Hhd, Hhd, Ql, Re, Re, Hhd^Fdw, Re, Re, Hhd, Re, Re, Gd, Gd, Re, Gd, Re^Es, Re^Es, Hhd^Fdw, Ha^Fdw, Ha^Fdw, Aa^Fpa, Aa^Fpa
Ha^Fp, Ha^Fp, Ha^Fmw, Ms, Ha^Fp, Ms^Xm, Hhd, Rb, Qlf, Qlf, Hhd, Hhd, Rb, Hhd, Hhd, Re, Gd^Es, Re, Re, Re, Re, Re^Fdw, Re, Ql, Ql, Hhd, Hhd, Re, Re, Qlf, Qlf, Gd^Fdw, Gd, Re, Re, Gd, Gd^Es, Gd^Es, Hhd, Re, Re^Es, Hhd, Hhd, Ha, Ha, Ha^Fdw, Ha
Ha^Fmw, Ha^Fmw, Ha^Fmw, Ha^Fmw, Hhd^Fp, Rb, Ql, Qlf, Rb, Qlf, Hhd, Hhd, Re, Re, Hhd, Re, Re^Es, Re^Es, Rb, Rb, Rb, Re, Ql, Re, Ql, Ql, Rb, Re, Ql, Ql, Gd, Gd, Re, Re, Re, Re, Re, Re^Es, Hhd, Hhd^Es, Ha^Es, Ha, Ha, Cfa, Hhd, Ha^Fdw, Ha
Ha, Ha, Ha^Fmw, Ha^Fmw, Rb^Es, Rb^Es, Ql, Rb, Hhd, Hhd, Ha, Hhd, Hhd, Hhd, Hhd, Hhd, Re, Rb, Qlf, Qlf, Rb^Es, Qlf, Rb, Re, Gd^Es, Ql, Gd, Rb, Gd, Ql, Ql, Re, Re, Re, Hhd, Re, Re, Hhd, Hhd, Hhd, Ha, Cfa, Cfa, Cfa, Hhd, Ha^Fdw, Ha
Ha^Fmw, Ha^Vhhr, Ha^Fdw, Hhd^Fmw, Re, Re, Hhd, Ql, Re, Ha, Ha, Hhd, Ha, Ha, Hhd, Hhd, Hhd, Ql, Hhd^Fdw, Rb, Hhd^Fdw, Rb^Es, Qlf, Qlf, Re, Gd^Es, Re^Fdw, Rb^Fdw, Gd, Ql, Rb, Re, Re^Fdw, Re^Fdw, Hhd, Hhd, Hhd, Re, Hhd, Hhd, Hhd, Cfa, 3 Kfa, Hhd, Hhd, Hhd, Hhd
Ha, Ha^Fmw, Ha^Fmw, Hhd, Cfa, Qlf, Hhd, Hhd, Re, Ha, Ha, Re, Ha, Ha^Fdw, Hhd, Hhd^Fdw, Hhd^Fdw, Ql, Ql, Hhd^Fdw, Hhd, Ql, Ql, Ql, Ql, Hhd, Hhd^Fdw, Hhd^Fdw, Rb, Qlf, Rb, Rb, Rb, Re, Hhd, Hhd^Fdw, Ha^Fdw, Ha, Ha, Ha, Ha, Hhd, Hhd^Fmw, Hhd, Hhd^Vhhr, Hhd, Ha^Fmw
Ha^Fmw, Ha, Ha, Cfa, 4 Kfa, Hhd, Ha, Ha, Ha, Ha, Ha, Ha, Re^Fdw, Re^Fdw, Hhd^Fdw, Hhd, Hhd, Ql, Re, Ql, Ql, Ql, Ql, Re, Ql, Ql, Hhd, Hhd, Ql, Rb, Rb, Hhd^Es, Rb^Fdw, Hhd^Es, Hhd^Fdw, Hhd, Hhd^Fdw, Ha^Fmw, Ha^Fmw, Ha, Ha, Hhd, Hhd, Ha^Fmw, Ha^Fmw, Ha^Fmw, Hhd
Ha^Fp, Ha^Fmw, Ha, Cfa, Cfa, Cfa, Hhd, Ha, Hhd, Hhd^Fp, Hhd, Hhd, Rb, Re, Qlf, Hhd, Hhd, Hhd, Ql, Ql, Hhd, Hhd, Re^Es, Re, Hhd, Hhd, Hhd, Ql, Ql, Qlf, Re, Rb, Rb, Hhd^Fdw, Ha^Fdw, Ha^Fdw, Ha^Fdw, Ha^Fdw, Ha^Fmw, Ha, Aa^Fmw, Ha^Fmw, Ha^Fmw, Ha^Fmw, Ha^Fp, Ha^Fmw, Hhd
Ha^Fp, Ha, Hhd, Ha, Ha, Hhd, Aa^Fpa, Aa^Fdw, Ha^Fdw, Hhd^Fp, Re^Es, Re^Es, Qlf, Ql, Re, Re, Hhd, Qlf, Qlf, Re, Rb, Re, Re, Re^Es, Re, Qlf, Hhd, Qlf, Qlf, Qlf, Rb, Re, Hhd^Fdw, Hhd^Fdw, Ha, Ha, Ha, Aa^Fmw, Ha^Fp, Aa^Fpa, Ha, Aa^Fpa, Aa^Fpa, Ha^Fpa, Ha^Fmw, Ha^Fp, Ha^Fp
Aa, Hhd^Fp, Hhd^Fp, Ha^Fmw, Ha, Ha, Aa^Fmw, Ha^Fmw, Ha^Fp, Hhd, Re, Qlf, Qlf, Ql, Ql, Rb, Rb, Hhd, Hhd^Fdw, Rb, Rb, Re, Re, Hhd, Cf, Ql, Ql, Hhd, Hhd, Rb, Rb, Hhd^Es, Hhd, Hhd, Hhd^Fdw, Ha, Ha, Ha^Fmw, Aa^Fmw, Aa^Fpa, Aa^Fmw, Ha^Fmw, Ha, Ha^Fp, Ha, Ha^Fmw, Ha^Fp
Ha^Fp, Hhd^Fp, Aa^Fmw, Aa^Fmw, Aa^Fdw, Aa^Fmw, Aa^Fdw, Aa^Fpa, Ha^Fp, Ha, Hhd, Gd, Ql, Ql, Re^Es, Rb, Rb, Hhd^Fdw, Hhd^Fdw, Hhd, Hhd^Fmw, Re, Cf, Cf, Cf, Cf, Ql, Ql, Rb, Rb^Fdw, Qlf, Hhd^Es, Hhd^Es, Hhd^Es, Gd^Fdw, Hhd^Fdw, Aa^Fdw, Aa^Fmw, Aa^Fp, Ha, Ha^Vhhr, Ha^Fp, Aa^Fp, Ha^Fp, Ha^Fmw, Ha^Fp, Ha^Fmw
Ha^Fp, Ha^Fdw, Ha^Fdw, Aa^Fmw, Aa^Fmw, Aa^Fmw, Ha^Vhhr, Aa^Fp, Aa^Fdw, Hhd, Gd^Fdw, Gd^Fdw, Qlf, Gd, Re^Es, Hhd^Fmw, Hhd^Fmw, Hhd, Ql, Re, Re, Re, Ql, 2 Kf, Ql, Cf, Ql, Hhd^Fdw, Hhd^Vhhr, Hhd, Re, Qlf, Qlf, Re^Es, Re^Es, Hhd^Fdw, Hhd, Ha^Fmw, Aa^Fmw, Aa^Fp, Ha^Fp, Ha^Fmw, Ha^Fmw, Ha^Fp, Ha^Fp, Ha^Fmw, Ha^Fmw
Ha^Fp, Ha^Fp, Ha^Fp, Ha^Fp, Ha^Fp, Ha^Fp, Ha^Fp, Ha^Fp, Hhd^Fp, Re, Re, Qlf, Rb^Fdw, Gd^Es, Hhd^Fmw, Hhd^Fmw, Hhd^Fmw, Hhd^Fmw, Qlf, Re, Gd, Ql, Rb, Ql, Hhd, Ql, Hhd, Hhd^Fdw, Hhd, Hhd, Gd, Qlf, Qlf, Re, Re^Es, Hhd^Fmw, Gll^Fmw, Aa^Fmw, Hhd, Ha^Fmw, Ha, Ha^Fp, Ha^Fp, Ha^Fp, Ha^Fp, Ha^Fmw, Ha^Fmw
Ha, Ha^Fp, Hhd^Fp, Ha^Fp, Ha^Fp, Gd, Gd, Hhd^Fp, Gd, Hhd^Fp, Gd, Gd, Gd, Rb, Gd, Hhd^Fmw, Gd, Hhd^Fmw, Gd, Gd, Gd, Rb, Gd, Gd, Gd, Hhd, Gd, Hhd, Hhd, Hhd, Gd, Gd, Gd, Gd, Hhd, Hhd, Hhd, Hhd, Aa^Fmw, Aa^Fmw, Hhd, Aa^Fmw, Ha, Ha^Fp, Ha^Fp, Ha, Ha
