Re, Re, Re, Gd, Gd, Gd, Gll, Uh, Ha, Ms, Ms, Uu, Ms, Uu, Ms^Xm, Ms^Xm, Ms^Xm, Ms^Xm, Ms, Ms^Xm, Ms^Xm, Ms, Ms, Ms, Ms^Xm, Ms, Ms^Xm, Ms, Ms^Xm, Ms, Ms^Xm, Ms, Ms^Xm, Ms, Ms^Xm, Ms, Ms^Xm, Ms, Ms^Xm, Ms, Ms, Ms, Ms^Xm, Ms
Re, Re, 2 Re, Re, Re, Gll, Gll, Ha, Ha, Ha^Esa, Ha^Esa, Ms, Ms, Ms^Xm, Ms, Ms, Ms^Xm, Ms^Xm, Ms^Xm, Ms, Ms^Xm, Ms^Xm, Ms^Xm, Ms^Xm, Ms^Xm, Ms^Xm, Ms^Xm, Ms^Xm, Ms^Xm, Ms^Xm, Ms, Ms^Xm, Ms^Xm, Ms^Xm, Ms^Xm, Ms, Ms^Xm, Ms^Xm, Ms^Xm, Ms^Xm, Ms^Xm, Ms^Xm, Ms^Xm, Ms^Xm
Re, Re, Re, Re, Re, Gd^Efm, Gll, Rb, Ha, Rb, Ha, Ms, Ms, Ms, Ms^Xm, Ms^Xm, Ms, Ms^Xm, Ms, Ms^Xm, Ms, Ms, Ms, Ms^Xm, Ms^Xm, Ms^Xm, Ms, Ms^Xm, Ms^Xm, Ms^Xm, Ms^Xm, Ms^Xm, Ms^Xm, Ms^Xm, Ms, Ms^Xm, Ms^Xm, Ms^Xm, Ms^Xm, Ms^Xm, Ms^Xm, Ms^Xm, Ms^Xm, Ms^Xm
Gd, Gll, Gll^Efm, Re, Rb, Re, Re, Re, Re, Rb, Rb^Esa, Ha, Ms, Ms, Ms^Xm, Ms^Xm, Cfa, Ms, Ms, Ms, Ms, Ha^Em, Ms, Ms, Ms, Ms, Ms, Ms, Ms, Ms, Ms, Ms^Xm, Ms^Xm, Ms^Xm, Ms, Ms, Ms, Ms, Ms, Ms, Ms, Ms^Xm, Ms^Xm, Ms^Xm
Ha, Gll, Gll, Gd^Efm, Rb, Rb^Es, Rb, Re, Re, Gd, Gd, Gll^Esa, Rb, Ms^Xm, Ai, Cfa, Kfa, Cfa, Re, Ms, Gll, Ha^Em, Ha^Em, Ha^Tf, Ha^Tf, Ha^Tf, Ms, Ms, Ms, Ms, Ms, Ms, Ms, Ms, Ms, Ms, Ai, Ms, Ai, Ms, Ms, Ms^Xm, Ms^Xm, Ms^Xm
Ha, Gll, Ha, Gd, Ha^Esa, Rb^Es, Rb, Re, Gd, 1 Re, Re, Gd^Efm, Ai, Ai, Ai, Cfa, Aa^Dr, Re, Gd^Efm, Gd, Rb, Gd, Rb, Gd^Emf, Gd^Emf, Ha^Emf, Ms, Cfa, Ms, Cfa, Ms, Ms, Ms, Ms, Ms, Ai, Ai, Ai, Ai, Ai, Ms, Ms, Ms^Xm, Ms^Xm
Ms, Ha^Esa, Ha^Esa, Gd, Ha, Ha^Esa, Rb, Gd^Efm, Gd, Re, Re, Gd, Re, Re^Esa, Re^Esa, Aa^Dr, Re, Gd, Gd, Rb, Rb^Es, Rb^Es, Gd, Rb, Gd, Gd, Re^Es, Re, Ha^Emf, Ha^Tf, Ha^Tf, Ms, Ms, Aa^Vca, Gll^Esa, Ai, Ai, Ai, Ai, Ai, Ms, Ms, Ms^Xm, Ms^Xm
Ms, Ms, Ha, Xu, Ha^Emf, Ha, Ha, Ha^Esa, Ha^Esa, Gll, Ai, Gd, Gd^Dr, Re, Ai, Re, Re, Re, Xu, Gd, Gd^Efm, Gd, Gd^Efm, Gd^Efm, Gd^Efm, Gd^Efm, Gd, Re^Es, Ha^Em, Ha^Emf, Ha^Em, Ha^Em, Gd^Esa, Gll, Ai, Ai, Xu, Ai, Ai, Ai, Ai, Ms, Ms, Ms^Xm
Ms, Ms, Ms, Ha^Emf, Ms, Ha^Emf, Ms, Ha, Ms, Ms, Ai, Gll, Ha^Esa, Rb, Gd^Dr, Gd^Dr, Cfa, Rb, Rb, Gd, Gd, Gd^Efm, Gd^Efm, Gd^Efm, Gd^Efm, Gd^Efm, Gd^Efm, Gd, Gd, Aa^Em, Gd^Efm, Gd, Gd^Es, Rb^Esa, Ai, Ai, Aa^Em, Cfa, Kfa, Ai, Ai, Ai, Ms, Ms
Ms^Xm, Ms^Xm, Ms^Xm, Ms, Ms, Ms, Ms, Ms, Ms, Ms^Xm, Ms^Xm, Ha, Ha^Emf, Ha^Esa, Gd^Dr, Cfa, Cfa, Ha, Ha, Gd, Gd^Vca, Gd, Gd, Gd, Re, Gd, Re^Esa, Gd, Gd, Gd, Gd^Efm, Gd, Ai, Gd^Efm, Cfa, Re^Es, Re, Cfa, Cfa, Xu, Ai, Ai, Ms, Ms
Ms^Xm, Ms^Xm, Ms^Xm, Ms, Ms, Ms, Ms^Xm, Ms, Ms^Xm, Ms^Xm, Ms, Ms, Ms, Ha^Em, Ms, Ms, Ms, Cfa, Ms, Ha^Esa, Gd^Esa, Xu, Xu, Xu, Xu, Re^Esa, Ha^Esa, Re, Gd, Gd, Gll^Es, Ai, Gd, Gd^Efm, Aa^Dr, Ai, Re^Esa, Re, Rb, Xu, Ai, Ai, Ms, Ms
Ms^Xm, Ms^Xm, Ms, Ms^Xm, Ms^Xm, Ms^Xm, Ms^Xm, Ms^Xm, Ms^Xm, Ms, Ms, Ms, Ms, Ms, Ms, Ms, Ms, Ms, Ms^Xm, Ha^Emf, Ms, Ha^Em, Ha, Xu, Ha^Emf, Ha^Emf, Ha^Tf, Re, Ms^Xm, Cfa, Kfa, Gd, Gd, Gd, Rb, Re, Re^Esa, Rb^Esa, Gll^Es, Gd, Ai, Ai, Ai, Ms
Ms^Xm, Ms^Xm, Ms^Xm, Ms^Xm, Ms, Ms^Xm, Ms^Xm, Ms^Xm, Ms, Ms^Xm, Ms^Xm, Ms^Xm, Ms^Xm, Ms^Xm, Ms^Xm, Ms^Xm, Ms^Xm, Ms^Xm, Ms, Ms^Xm, Ms^Xm, Ms, Ms^Xm, Ha, Ms, Ha^Tf, Ms^Xm, Ha^Tf, Ms^Xm, Cfa, Ms^Xm, Ai, Ai, Ai, Ai, Gd, Gd^Efm, Gll, Gll^Es, Ai, Ai, Ai, Ai, Ms
Ms, Ms^Xm, Ms^Xm, Ms^Xm, Ms, Ms^Xm, Ms, Ms, Ms, Ms, Ms, Ms, Ms, Ms^Xm, Ms, Ms^Xm, Ms, Ms, Ha^Esa, Ms, Ms, Ms^Xm, Ms, Ms^Xm, Ms^Xm, Ms^Xm, Ms, Ms^Xm, Cfa, Ms^Xm, Aa^Vca, Ms^Xm, Ai, Ai, Ai, Gd^Efm, Gd^Efm, Gd, Ai, Ai, Ai, Ai, Ms, Ms
Ms^Xm, Ms^Xm, Ms^Xm, Ms^Xm, Ms, Ms, Ms, Ms, Ms, Ms, Aa^Fda, Ms, Ms, Aa^Vca, Gd, Ha, Ha, Ha^Esa, Ha, Ha^Esa, Ms, Ms, Ms, Ms, Aa^Fpa, Ms, Aa^Fda, Aa^Fpa, Re, Ms, Ai, Ms^Xm, Ai, Ai, Rb, Ai, Gd^Efm, Ai, Ai, Ai, Aa, Ai, Ms, Ms
Ms, Ms^Xm, Ms, Ms^Xm, Ms, Ms, Ms, Ms, Aa^Fpa, Aa^Fma, Aa^Fda, Aa^Fpa, Aa^Fpa, Ha^Em, Rb^Esa, Xu, Gd, Gd, Gd^Efm, Gd, Gd, Aa^Vca, Rb, Re, Rb^Es, Re, Rb, Re, Gll, Gll, Gll, Ai, Rb, Ai, Rb, Rb^Es, Ai, Ai, Ai, Ai, Ai, Ha, Ms, Ms
Ms^Xm, Ms^Xm, Ms, Ms, Ms, Ms, Ms, Ms, Aa^Fma, Aa^Feta, Aa^Fpa, Aa^Fma, Gd^Efm, Gd, Gd^Esa, Rb^Esa, Xu, Xu, Xu, Ha^Esa, Ha, Gd, Gd^Es, Rb^Es, Gd^Efm, Rb, Gd^Efm, Gd, Gd^Em, Gd, Gd^Efm, Gd, Gd^Efm, Rb^Esa, Re^Esa, Re, Ai, Ai, Ai, Ai, Ha, Ha, Ms^Xm, Ms
Ms^Xm, Ms, Ms^Xm, Ms, Ms, Ms, Ms^Xm, Ms, Aa^Fma, Aa^Fpa, Aa^Fda, Gd, Gd, Gd^Efm, Gd^Efm, Xu, Xu, Cfa, Ha, Ha^Esa, 3 Kfa, Cfa, Cfa, Gd^Es, Gll, Gd^Efm, Re, Re, Re, Gd, Ai, Gd^Efm, Gd^Em, Re^Esa, Aa^Vca, Ai, Ai, Re^Esa, Ms^Xm, Ai, Ha, Ms, Ms^Xm, Ms
Ms, Ms^Xm, Ms^Xm, Ms^Xm, Ms, Ms, Ms, Ms^Xm, Ms^Xm, Aa^Fda, Aa^Fpa, Xu, Gd, Gd^Efm, Gd^Efm, Aa^Fpa, Ha^Esa, Xu, Ha^Esa, Ha^Esa, Cfa, Xu, Gll^Esa, Gll^Es, Gd^Esa, Gd, Xu, Xu, Xu, Xu, Ai, Ai, Ai, Ai, Ai, Ai, Re, Re^Esa, Ms^Xm, Ms^Xm, Ms^Xm, Ms, Ms^Xm, Ms
Ms^Xm, Ms^Xm, Ms^Xm, Ms^Xm, Ms^Xm, Ms, Ms^Xm, Ms, Ms, Ms, Aa^Fpa, Xu, Gd^Efm, Rb^Es, Gll, Gd, Gd^Efm, Ha, Ha, Xu, Gd^Efm, Aa^Dr, Gd^Es, Gll^Esa, Xu, Re, Rb, Ha, Rb^Esa, Rb^Esa, Rb^Es, Aa, Ms^Xm, Ms^Xm, Ai, Ai, Re, Ms^Xm, Ha^Esa, Ms^Xm, Ms^Xm, Ms^Xm, Ms^Xm, Ms^Xm
Ms^Xm, Ms^Xm, Ms^Xm, Ms^Xm, Ms^Xm, Ms^Xm, Ms^Xm, Ms, Ms, Ms, Ms, Ha, Rb, Rb^Es, Gll^Esa, Gll^Esa, Ha, Gd, Gd, Gll, Gd, Gd, Re, Gll, Xu, Xu, Rb^Es, Rb^Es, Rb^Es, Rb^Es, Cfa, Cfa, Xu, Xu, Xu, Ai, Re, Rb^Esa, Rb^Esa, Xu, Xu, Ms, Ms^Xm, Ms^Xm
Ms, Ms^Xm, Ms^Xm, Ms^Xm, Ms, Ms^Xm, Ms^Xm, Ms, Ms, Aa^Vca, Re, Re, Gd, Rb, Ai, Ha^Esa, Xu, Ai, Xu, Xu, Rb, Re, Gd^Esa, Gd, Gd^Efm, Rb, Re^Esa, Aa^Vca, Xu, Xu, Aa^Vca, Kfa, Xu, Cfa, Xu, Aa^Tf, Aa^Es, Rb^Esa, Re, Aa, Xu, Ms, Ms, Ms^Xm
Ms, Ms^Xm, Ms^Xm, Ms^Xm, Ms, Ms, Ms^Xm, Ms^Xm, Ms, Ms, Re, Xu, Gd^Esa, Ai, Ai, Ai, Xu, Xu, Xu, Aa^Emf, Re, Re^Esa, Gll^Esa, Gd^Efm, Gd^Efm, Gd, Re^Esa, Ha^Esa, Ms^Xm, Xu, Ms, Xu, Aa^Vca, Aa, Xu, Aa^Tf, Aa^Es, Rb, Aa^Es, Cfa, Cfa, Xu, Ms^Xm, Ms^Xm
Ms, Ms, Ms, Ms, Ms, Ms, Ms^Xm, Ms^Xm, Ms, Ms, Re, Gd^Esa, Ai, Ai, Ai, Gd, Xu, Xu, Xu, Ha^Tf, Re, Re^Esa, Re, Xu, Xu, Gd, Gd, Ms^Xm, Ms, Ms, Ms^Xm, Xu, Xu, Ha^Emf, Ha^Emf, Ha^Emf, Aa^Em, Aa, Cfa, Kfa, Cfa, Ms, Ms^Xm, Ms^Xm
Ms, Ms, Ms, Ms, Ms^Xm, Ms^Xm, Ms^Xm, Ms^Xm, Ms, Cfa, Ms, Gd^Esa, Gll, Ai, Ai, Gd, Gd^Esa, Gll^Esa, Ai, Xu, Ai, Re, Gd^Efm, Re, Ai, Ai, Gd, Ai, Gll, Ms, Ms^Xm, Xu, Ms, Xu, Rb^Em, Aa^Em, Aa, Aa^Em, Ha^Emf, Xu, Xu, Ms, Ms^Xm, Ms^Xm
Ms^Xm, Ms, Ms^Xm, Ms^Xm, Ms^Xm, Ms^Xm, Ms, Ms, Ms, Ms, Ai, Ms, Gll, Ai, Ai, Ai, Ai, Ai, Ai, Ai, Ai, Gd, Gd^Efm, Gd^Efm, Gd^Efm, Ai, Gd^Efm, Gll, Ai, Aa^Vca, Ms, Xu, Ha, Rb, Re^Esa, Rb, Xu, Ha^Em, Aa^Vca, Xu, Xu, Ms, Ms^Xm, Ms^Xm
Ms^Xm, Ms, Ms^Xm, Ms^Xm, Ms^Xm, Ms, Ms, Ms, Ms, Ai, Ai, Rb, Ai, Ai, Ai, Ai, Ha, Ai, Ha, Ai, Ai, Gd, Ai, Gd^Efm, Gd, Re, Re^Esa, Re, Re, Aa, Ms, Ms, Aa, Rb, Re, Re^Esa, Re^Em, Ha, Aa^Tf, Xu, Ms, Ms^Xm, Ms^Xm, Ms^Xm
Ms^Xm, Ms^Xm, Ms, Ms^Xm, Ms, Ms, Ha^Esa, Ai, Ai, Ai, Xu, Rb^Em, Rb^Esa, Ai, Xu, Xu, Xu, Ha^Em, Ha^Em, Ha, Ha, Ha, Gd, Gd, Xu, Gd^Esa, Ai, Re, Xu, Re, Re, Aa, Re, Re, Ha, Re^Em, Xu, Ha^Emf, Ms, Ms, Ms^Xm, Ms^Xm, Ms^Xm, Ms^Xm
Ms^Xm, Ms, Ms, Ms, Ha^Esa, Ha, Ai, Ai, Ai, Ai, Xu, Re, Re^Esa, Re^Esa, Xu, Xu, Xu, Ha^Tf, Gll^Em, Ha, Gd, Rb, Rb^Em, Rb^Em, Xu, Xu, Ai, Xu, Xu, Xu, Re^Esa, Re^Esa, Rb^Es, Ha, Ha^Emf, Ha^Emf, Xu, Xu, Ms, Ms, Ms^Xm, Ms^Xm, Ms^Xm, Ms^Xm
Ms^Xm, Ms, Ms, Aa^Vka, Isa^Esa, Ai, Ai, Ai, Ai, Xu, Xu, Xu, Cfa, Re, Rb, Xu, Rb, Rb^Em, Rb^Es, Gll, Gd^Es, Rb, Rb, Re, Re^Esa, Rb, Re, Re, Re^Esa, Aa, Re, Re^Esa, Rb^Es, Aa^Vca, Ms, Xu, Ms, Xu, Ms, Ms, Ms^Xm, Ms^Xm, Ms^Xm, Ms^Xm
Ms, Ms^Xm, Ms, Ha^Esa, Ha^Esa, Isa, Ai, Ai, Isa, Ai, Xu, Xu, Xu, Xu, Ai, Rb^Em, Xu, Xu, Gd, Rb, Gd^Esa, Ai, Re^Esa, Re^Esa, Re, Re^Esa, Ai, Aa, Ha^Em, Re^Esa, Re, Re, Rb, Ms, Ms, Ms, Ms^Xm, Ms, Ms^Xm, Ms, Ms^Xm, Ms, Ms^Xm, Ms^Xm
Ms^Xm, Ms^Xm, Ms^Xm, Ms, Ms, Ai, Ai, Ai, Isa^Es, Isa^Es, Aa^Vka, Xu, Ai, Xu, Ai, Xu, Xu, Xu, Ai, Gd^Esa, Ai, Ai, Ai, Re^Esa, Ai, Aa, Ai, Aa^Vca, Ai, Ha^Tf, Rb^Esa, Re, Re, Aa, Ai, Ms, Ms, Ms^Xm, Ms, Ms^Xm, Ms, Ms, Ms^Xm, Ms
Ms^Xm, Ms^Xm, Ms, Ms, Qlf, Ms, Aa^Esa, Aa^Esa, Isa, Isa, Isa, Xu, Ai, Ai, Xu, Xu, Xu, Ai, Ai, Ai, Xu, Ai, Xu, Ai, Ai, Ai, Ai, Ai, Ai, Ai, Aa^Esa, Aa^Esa, Aa, Aa, Ai, Ms, Ms, Ms, Ms, Ms, Ms^Xm, Ms^Xm, Ms^Xm, Ms
Ms^Xm, Ms, Aa^Vka, Ha, Qlf, Qlf, Qlf, Qlf, Qlf, Qlf, Qlf, Isa^Esa, Isa^Esa, Ai, Aa^Vka, Xu, Xu, Ai, Ai, Xu, Aa^Vca, Xu, Ha^Esa, Ha^Esa, Ha, Gll, Gll, Ai, Gd^Es, Gd^Es, Gd, Rb, Rb^Es, Ai, Ai, Ai, Ha, Ms, Ms, Ms, Ms^Xm, Ms^Xm, Ms^Xm, Ms
Ms^Xm, Ms, Ha, Qlf, Qlf, Qlf, Qlf, 4 Kfa, Cfa, Cfa, Cfa, Qlf, Isa, Ai, Isa, Xu, Ha, Ai, Aa^Es, Ai, Ha, Ha, Ha^Esa, Ha^Esa, Aa, Ha, Rb, Gd, Gd, Rb, Rb^Esa, Rb, Rb, Rb, Xu, Ai, Ha, Ms, Ms^Xm, Ms^Xm, Ms, Ms, Ms^Xm, Ms
Ms^Xm, Ms^Xm, Mv, Ha, Ms, Aa, Aa^Esa, Isa, Cfa, Xu, Cfa, Isa, Aa^Esa, Isa^Es, Isa^Es, Isa, Isa, Aa^Es, Ai, Rb, Ha, Rb, Aa^Es, Gd, Gd^Efm, Gd, Gd^Efm, Gd^Efm, Gd^Efm, Gd, Rb^Esa, Rb^Esa, Ha^Esa, Re, Gd, Ai, Rb^Es, Ha, Ms, Ms^Xm, Ms^Xm, Ms^Xm, Ms, Ms
Ms^Xm, Ms^Xm, Ms^Xm, Ms^Xm, Ms, Aa, Isa^Esa, Isa^Esa, Qlf, Cfa, Qlf, Isa, Isa, Ha^Esa, Ha, Ai, Aa^Es, Aa^Es, Ha, Rb, Rb, Xu, Gd^Efm, Gd, Gd, 5 Gd^Efm, Gd, Gd, Gd, Rb, Ha^Em, Aa^Esa, Aa, Gd^Efm, Gd^Es, Re, Ha, Ha, Ms, Ms, Ms, Ms^Xm, Ms, Ms
Ms^Xm, Ms^Xm, Ms, Ms, Ms, Aa^Vka, Isa, Aa, Qlf, Qlf, Qlf, Qlf, Aa^Esa, Ai, Xu, Xu, Ai, Aa^Es, Rb, Rb, Rb, Xu, Gd^Efm, Gd^Efm, Gd^Efm, Gd^Efm, Gd, Gd^Efm, Gd, Ha^Emf, Ha^Tf, Xu, Ha, Rb, Gd, Gd^Efm, Ha, Ms, Ms, Ms, Ms, Ms^Xm, Ms^Xm, Ms^Xm
Ms, Ms^Xm, Ms^Xm, Ms, Ms, Ms, Ms^Xm, Ms, Ms^Xm, Qlf, Xu, Aa^Esa, Xu, Aa^Vka, Xu, Xu, Xu, Ai, Rb^Esa, Xu, Rb, Gd, Gd^Es, Gd, Gll, Gd^Efm, Gll^Es, Rb, Aa^Vca, Ha^Emf, Ha^Tf, Xu, Xu, Ha^Esa, Aa, Rb, Aa^Esa, Ha^Esa, Ms, Ms, Ms, Ms^Xm, Ms^Xm, Ms^Xm
Ms, Ms^Xm, Ms^Xm, Ms^Xm, Ms, Ms^Xm, Ms, Ms^Xm, Mv, Ms, Ms, Xu, Xu, Xu, Xu, Xu, Xu, Ha^Esa, Ha^Esa, Rb, Gd, Gd, Ai, Gd, Ai, Gll, Ha, Ha, Xu, Xu, Xu, Xu, Aa^Vca, Xu, Ha, Aa, Rb, Ha^Esa, Cfa, Ms, Ms, Ms^Xm, Ms^Xm, Ms^Xm
Ms^Xm, Ms^Xm, Ms^Xm, Ms^Xm, Ms^Xm, Ms, Ms, Ms^Xm, Ms^Xm, Ms^Xm, Ms, Xu, Xu, Xu, Xu, Xu, Ha, Ha^Esa, Rb, Rb, Xu, Gd, Ai, Ai, Ai, Ai, Ai, Ai, Ai, Ai, Ai, Ai, Ai, Ha, Ai, Rb, Ha, Cfa, Kfa, Cfa, Ms^Xm, Ms, Ms^Xm, Ms^Xm
Ms^Xm, Ms^Xm, Ms^Xm, Ms^Xm, Ms^Xm, Ms^Xm, Ms, Ms^Xm, Ms, Ms^Xm, Ms, Ms, Ha^Tf, Xu, Xu, Xu, Ha, Ha, Rb^Esa, Aa^Esa, Xu, Ai, Ai, Ai, Ai, Ai, Ai, Ai, Ai, Ai, Ai, Ai, Ai, Ai, Ai, Ai, Ms, Cfa, Ms, Ms, Ms^Xm, Ms, Ms^Xm, Ms^Xm
Ms^Xm, Ms^Xm, Ms^Xm, Ms^Xm, Ms^Xm, Ms^Xm, Ms, Ms, Ms, Ms, Ha, Ha, Ha^Em, Ha^Em, Gll, Gll, Aa^Es, Re, Re, Re^Esa, Ha, Ai, Ai, Ms, Ms, Ai, Ai, Ai, Ai, Ai, Ai, Ai, Ai, Ms, Ms, Ms, Ms, Ms, Ms, Ms^Xm, Ms^Xm, Ms^Xm, Ms^Xm, Ms^Xm
Ms^Xm, Ms^Xm, Ms^Xm, Ms^Xm, Ms, Ms^Xm, Ms^Xm, Ms, Ms, Ha, Gll, Gll, Gd^Esa, Gll, Re, Re^Es, Re, Re^Es, Ha^Em, Re, Ai, Ai, Ms, Ms, Ms^Xm, Ms, Ms, Ms, Ms, Ms, Ms, Ai, Ms, Ms, Ms, Ms^Xm, Ms^Xm, Ms^Xm, Ms^Xm, Ms^Xm, Ms^Xm, Ms^Xm, Ms^Xm, Ms^Xm
Ms^Xm, Ms^Xm, Ms^Xm, Ms^Xm, Ms^Xm, Ms^Xm, Ms, Ms, Aa^Vca, Ha, Gd, Re, Re^Esa, Re, Gd, Re, Ha, Gd^Em, Ha^Tf, Ha^Em, Ms, Ms, Ms, Ms^Xm, Ms^Xm, Ms^Xm, Ms, Ms, Ms^Xm, Ms, Ms^Xm, Ms, Ms, Ms^Xm, Ms^Xm, Ms^Xm, Ms^Xm, Ms^Xm, Ms^Xm, Ms^Xm, Ms^Xm, Ms^Xm, Ms^Xm, Ms^Xm
Ms^Xm, Ms^Xm, Ms, Ms, Ms, Ms^Xm, Ms, Ms, Ms, Gll, Rb, Re^Esa, Re^Esa, Gd, Gll, Ha^Es, Ha^Em, Ha^Em, Ha^Tf, Ha^Em, Ms, Ms^Xm, Ms^Xm, Ms, Ms, Ms^Xm, Ms^Xm, Ms, Ms^Xm, Ms^Xm, Ms^Xm, Ms, Ms^Xm, Ms, Ms, Ms^Xm, Ms^Xm, Ms^Xm, Ms^Xm, Ms^Xm, Ms^Xm, Ms^Xm, Ms^Xm, Ms^Xm
Ms^Xm, Ms^Xm, Ms^Xm, Ms, Ms, Ms, Ha, Ha, Rb^Es, Gll^Es, Rb^Esa, Re, Gd, Gll, Ha, Ha^Es, Ms, Ha^Tf, Ms, Ms, Ms, Ms, Ms^Xm, Ms^Xm, Ms^Xm, Ms^Xm, Ms^Xm, Ms^Xm, Ms^Xm, Ms^Xm, Ms^Xm, Ms^Xm, Ms^Xm, Ms^Xm, Ms^Xm, Ms^Xm, Ms^Xm, Ms^Xm, Ms^Xm, Ms^Xm, Ms^Xm, Ms^Xm, Ms^Xm, Ms^Xm
Ms^Xm, Ms^Xm, Ms^Xm, Ms, Ms, Ms, Ha, Gll^Es, Re, Re, Re^Esa, Re^Esa, Rb, Ms, Ms, Ms, Ms^Xm, Ms, Ms^Xm, Ms, Ms^Xm, Ms, Ms^Xm, Ms^Xm, Ms^Xm, Ms^Xm, Ms^Xm, Ms^Xm, Ms^Xm, Ms^Xm, Ms^Xm, Ms^Xm, Ms^Xm, Ms^Xm, Ms^Xm, Ms^Xm, Ms^Xm, Ms^Xm, Ms^Xm, Ms^Xm, Ms^Xm, Ms^Xm, Ms^Xm, Ms^Xm
Ms, Ms^Xm, Ms, Ms, Ms, Ms, Uu, Re, Uu, Re, Re, Re, Uu, Ms, Ms, Ms^Xm, Ms, Ms^Xm, Ms, Ms^Xm, Ms^Xm, Ms^Xm, Ms^Xm, Ms^Xm, Ms^Xm, Ms^Xm, Ms^Xm, Ms^Xm, Ms^Xm, Ms^Xm, Ms^Xm, Ms^Xm, Ms^Xm, Ms^Xm, Ms, Ms^Xm, Ms^Xm, Ms^Xm, Ms^Xm, Ms^Xm, Ms^Xm, Ms^Xm, Ms, Ms^Xm
