Re, Re, Re, Gd, Gd, Gd, Gll, Uh, Uh, Ms, Ms, Uu, Ms, Uu, Ms^Xm, Ms^Xm, Ms^Xm, Ms^Xm, Ms, Ms^Xm, Ms^Xm, Ms, Ms, Ms, Ms^Xm, Mm, Ms^Xm, Mm, Ms^Xm, Mm, Ms^Xm, Mm, Ms^Xm, Mm, Ms^Xm, Ms, Ms^Xm, Mm, Ms^Xm, Ms, Ms, Ms, Ms^Xm, Mm
Re, Re, 2 Re, Re, Re, Gll, Gll, Uh, Uh, Uh, Uh, Ms, Ms, Ms^Xm, Ms, Ms, Ms^Xm, Ms^Xm, Ms^Xm, Ms, Ms^Xm, Ms^Xm, Ms^Xm, Ms^Xm, Ms^Xm, Ms^Xm, Ms^Xm, Ms^Xm, Ms^Xm, Ms^Xm, Ms, Ms^Xm, Ms^Xm, Ms^Xm, Ms^Xm, Ms, Ms^Xm, Ms^Xm, Ms^Xm, Ms^Xm, Ms^Xm, Ms^Xm, Ms^Xm, Ms^Xm
Re, Re, Re, Re, Re, Gd^Efm, Gll, Rb, Uh, Rb, Uh, Ms, Ms, Ms, Ms^Xm, Ms^Xm, Ms, Ms^Xm, Ms, Ms^Xm, Ms, Ms, Ms, Ms^Xm, Ms^Xm, Ms^Xm, Ms, Ms^Xm, Ms^Xm, Ms^Xm, Ms^Xm, Ms^Xm, Ms^Xm, Ms^Xm, Ms, Ms^Xm, Ms^Xm, Ms^Xm, Ms^Xm, Ms^Xm, Ms^Xm, Ms^Xm, Ms^Xm, Ms^Xm
Gd, Gll, Gll^Efm, Re, Rb, Re, Re, Re, Re, Rb, Rb, Uh, Ms, Ms, Ms^Xm, Ms^Xm, Cud, Ms, Ms, Ms, Ms, Uh^Em, Ms, Ms, Ms, Ms, Ms, Ms, Ms, Ms, Ms, Ms^Xm, Ms^Xm, Ms^Xm, Ms, Ms, Ms, Ms, Ms, Ms, Ms, Ms^Xm, Ms^Xm, Mm
Uh, Gll, Gll, Gd^Efm, Rb, Rb^Es, Rb, Re, Re, Gd, Gd, Gll, Rb, Ms^Xm, Ai, Cud, Kud, Cud, Re, Ms, Gll, Uh^Em, Uh^Em, Uh^Tf, Uh^Tf, Uh^Tf, Ms, Ms, Ms, Ms, Ms, Ms, Ms, Ms, Ms, Ms, Ai, Ms, Ai, Ms, Ms, Ms^Xm, Ms^Xm, Ms^Xm
Uh, Gll, Uh, Gd, Uh, Rb^Es, Rb, Re, Gd, 1 Re, Re, Gd^Efm, Ai, Ai, Ai, Cud, Uu^Dr, Re, Gd^Efm, Gd, Rb, Gd, Rb, Gd^Emf, Gd^Emf, Uh^Emf, Ms, Cud, Ms, Cud, Ms, Ms, Ms, Ms, Ms, Ai, Ai, Ai, Ai, Ai, Ms, Ms, Ms^Xm, Ms^Xm
Ms, Uh, Uh, Gd, Uh, Uh, Rb, Gd^Efm, Gd, Re, Re, Gd, Re, Re, Re, Uu^Dr, Re, Gd, Gd, Rb, Rb^Es, Rb^Es, Gd, Rb, Gd, Gd, Re^Es, Re, Uh^Emf, Uh^Tf, Uh^Tf, Ms, Ms, Uu^Vud, Gll, Ai, Ai, Ai, Ai, Ai, Ms, Ms, Ms^Xm, Ms^Xm
Ms, Ms, Uh, Xu, Uh^Emf, Uh, Uh, Uh, Uh, Gll, Ai, Gd, Gd^Dr, Re, Ai, Re, Re, Re, Xu, Gd, Gd^Efm, Gd, Gd^Efm, Gd^Efm, Gd^Efm, Gd^Efm, Gd, Re^Es, Uh^Em, Uh^Emf, Uh^Em, Uh^Em, Gd, Gll, Ai, Ai, Xu, Ai, Ai, Ai, Ai, Ms, Ms, Ms^Xm
Ms, Ms, Ms, Uh^Emf, Ms, Uh^Emf, Ms, Uh, Ms, Ms, Ai, Gll, Uh, Rb, Gd^Dr, Gd^Dr, Cud, Rb, Rb, Gd, Gd, Gd^Efm, Gd^Efm, Gd^Efm, Gd^Efm, Gd^Efm, Gd^Efm, Gd, Gd, Uu^Em, Gd^Efm, Gd, Gd^Es, Rb, Ai, Ai, Uu^Em, Cud, Kud, Ai, Ai, Ai, Ms, Ms
Ms^Xm, Ms^Xm, Ms^Xm, Ms, Ms, Ms, Ms, Ms, Ms, Ms^Xm, Ms^Xm, Uh, Uh^Emf, Uh, Gd^Dr, Cud, Cud, Uh, Uh, Gd, Gd^Vud, Gd, Gd, Gd, Re, Gd, Re, Gd, Gd, Gd, Gd^Efm, Gd, Ai, Gd^Efm, Cud, Re^Es, Re, Cud, Cud, Xu, Ai, Ai, Ms, Ms
Ms^Xm, Ms^Xm, Ms^Xm, Ms, Ms, Ms, Ms^Xm, Ms, Ms^Xm, Ms^Xm, Ms, Ms, Ms, Uh^Em, Ms, Ms, Ms, Cud, Ms, Uh, Gd, Xu, Xu, Xu, Xu, Re, Uh, Re, Gd, Gd, Gll^Es, Ai, Gd, Gd^Efm, Uu^Dr, Ai, Re, Re, Rb, Xu, Ai, Ai, Ms, Ms
Ms^Xm, Ms^Xm, Ms, Ms^Xm, Ms^Xm, Ms^Xm, Ms^Xm, Ms^Xm, Ms^Xm, Ms, Ms, Ms, Ms, Ms, Ms, Ms, Ms, Ms, Ms^Xm, Uh^Emf, Ms, Uh^Em, Uh, Xu, Uh^Emf, Uh^Emf, Uh^Tf, Re, Ms^Xm, Cud, Kud, Gd, Gd, Gd, Rb, Re, Re, Rb, Gll^Es, Gd, Ai, Ai, Ai, Ms
Ms^Xm, Ms^Xm, Ms^Xm, Ms^Xm, Ms, Ms^Xm, Ms^Xm, Ms^Xm, Ms, Ms^Xm, Ms^Xm, Ms^Xm, Ms^Xm, Ms^Xm, Ms^Xm, Ms^Xm, Ms^Xm, Ms^Xm, Ms, Ms^Xm, Ms^Xm, Ms, Ms^Xm, Uh, Ms, Uh^Tf, Ms^Xm, Uh^Tf, Ms^Xm, Cud, Ms^Xm, Ai, Ai, Ai, Ai, Gd, Gd^Efm, Gll, Gll^Es, Ai, Ai, Ai, Ai, Ms
Ms, Ms^Xm, Ms^Xm, Ms^Xm, Ms, Ms^Xm, Ms, Ms, Ms, Ms, Ms, Ms, Ms, Ms^Xm, Ms, Ms^Xm, Ms, Ms, Uh, Ms, Ms, Ms^Xm, Ms, Ms^Xm, Ms^Xm, Ms^Xm, Ms, Ms^Xm, Cud, Ms^Xm, Uu^Vu, Ms^Xm, Ai, Ai, Ai, Gd^Efm, Gd^Efm, Gd, Ai, Ai, Ai, Ai, Ms, Ms
Ms^Xm, Ms^Xm, Ms^Xm, Ms^Xm, Ms, Ms, Ms, Ms, Ms, Ms, Gll^Fp, Ms, Ms, Uu^Vud, Gd, Uh, Uh, Uh, Uh, Uh, Ms, Ms, Ms, Ms, Re^Fp, Ms, Re^Fp, Re^Fp, Re, Ms, Ai, Ms^Xm, Ai, Ai, Rb, Ai, Gd^Efm, Ai, Ai, Ai, Gll, Ai, Ms, Ms
Ms, Ms^Xm, Ms, Ms^Xm, Ms, Ms, Ms, Ms, Gll^Fp, Gll^Fp, Gll^Fp, Gll^Fp, Gll^Fp, Uh^Em, Rb, Xu, Gd, Gd, Gd^Efm, Gd, Gd, Uu^Vud, Rb, Re, Rb^Es, Re, Rb, Re, Gll, Gll, Gll, Ai, Rb, Ai, Rb, Rb^Es, Ai, Ai, Ai, Ai, Ai, Uh, Ms, Ms
Ms^Xm, Ms^Xm, Ms, Ms, Ms, Ms, Ms, Ms, Gll^Fp, Gll^Fet, Gll^Fp, Gll^Fp, Gd^Efm, Gd, Gd, Rb, Xu, Xu, Xu, Uh, Uh, Gd, Gd^Es, Rb^Es, Gd^Efm, Rb, Gd^Efm, Gd, Gd^Em, Gd, Gd^Efm, Gd, Gd^Efm, Rb, Re, Re, Ai, Ai, Ai, Ai, Uh, Uh, Ms^Xm, Ms
Ms^Xm, Ms, Ms^Xm, Ms, Ms, Ms, Md^Xm, Ms, Gll^Fp, Gll^Fp, Gll^Fp, Gd, Gd, Gd^Efm, Gd^Efm, Xu, Xu, Cud, Uh, Uh, 3 Kud, Cud, Cud, Gd^Es, Gll, Gd^Efm, Re, Re, Re, Gd, Ai, Gd^Efm, Gd^Em, Re, Re^Vu, Ai, Ai, Re, Ms^Xm, Ai, Uh, Ms, Ms^Xm, Ms
Ms, Ms^Xm, Ms^Xm, Ms^Xm, Ms, Ms, Ms, Md^Xm, Md^Xm, Gll^Fp, Gll^Fp, Xu, Gd, Gd^Efm, Gd^Efm, Gll^Fp, Uh, Xu, Uh, Uh, Cud, Xu, Gll, Gll^Es, Gd, Gd, Xu, Xu, Xu, Xu, Ai, Ai, Ai, Ai, Ai, Ai, Re, Re, Ms^Xm, Ms^Xm, Ms^Xm, Ms, Ms^Xm, Ms
Ms^Xm, Ms^Xm, Ms^Xm, Ms^Xm, Ms^Xm, Ms, Ms^Xm, Ms, Ms, Ms, Gll^Fp, Xu, Gd^Efm, Rb^Es, Gll, Gd, Gd^Efm, Uh, Uh, Xu, Gd^Efm, Uu^Dr, Gd^Es, Gll, Xu, Re, Rb, Uh, Rb, Rb, Rb^Es, Uu, Mm^Xm, Mm^Xm, Ai, Ai, Re, Ms^Xm, Uh, Ms^Xm, Ms^Xm, Ms^Xm, Ms^Xm, Ms^Xm
Ms^Xm, Ms^Xm, Ms^Xm, Ms^Xm, Ms^Xm, Ms^Xm, Ms^Xm, Ms, Ms, Ms, Ms, Uh, Rb, Rb^Es, Gll, Gll, Uh, Gd, Gd, Gll, Gd, Gd, Re, Gll, Xu, Xu, Rb^Es, Rb^Es, Rb^Es, Rb^Es, Cud, Cud, Xu, Xu, Xu, Ai, Re, Rb, Rb, Xu, Xu, Ms, Ms^Xm, Ms^Xm
Ms, Ms^Xm, Ms^Xm, Ms^Xm, Ms, Ms^Xm, Ms^Xm, Ms, Ms, Uu^Vud, Urb, Urb, Gd, Rb, Ai, Uh, Xu, Ai, Xu, Xu, Rb, Re, Gd, Gd, Gd^Efm, Rb, Re, Uu^Vud, Xu, Xu, Uu^Vud, Kud, Xu, Cud, Xu, Uu^Tf, Uu^Es, Rb, Re, Uu^Es, Xu, Ms, Ms, Ms^Xm
Ms, Ms^Xm, Ms^Xm, Ms^Xm, Ms, Ms, Ms^Xm, Ms^Xm, Ms, Ms, Urb, Xu, Gd, Ai, Ai, Ai, Xu, Xu, Xu, Uu^Emf, Re, Re, Gll, Gd^Efm, Gd^Efm, Gd, Re, Uh, Ms^Xm, Xu, Ms, Xu, Uu^Vu, Uu, Xu, Uu^Tf, Uu^Es, Rb, Uu^Es, Cud, Cud, Xu, Ms^Xm, Ms^Xm
Ms, Ms, Ms, Ms, Ms, Ms, Ms^Xm, Ms^Xm, Ms, Ms, Urb, Gd, Ai, Ai, Ai, Gd, Xu, Xu, Xu, Uh^Tf, Re, Re, Re, Xu, Xu, Gd, Gd, Ms^Xm, Ms, Ms, Ms^Xm, Xu, Xu, Uh^Emf, Uh^Emf, Uh^Emf, Uu^Em, Uu, Cud, Kud, Cud, Ms, Ms^Xm, Ms^Xm
Ms, Ms, Ms, Ms, Ms^Xm, Ms^Xm, Ms^Xm, Ms^Xm, Ms, Cud, Ms, Gd, Gll, Ai, Ai, Gd, Gd, Gll, Ai, Xu, Ai, Re, Gd^Efm, Re, Ai, Ai, Gd, Ai, Gll, Ms, Ms^Xm, Xu, Ms, Xu, Rb^Em, Uu^Em, Uu, Uu^Em, Uh^Emf, Xu, Xu, Ms, Ms^Xm, Ms^Xm
Ms^Xm, Ms, Ms^Xm, Ms^Xm, Ms^Xm, Ms^Xm, Ms, Ms, Ms, Ms, Ai, Ms, Gll, Ai, Ai, Ai, Ai, Ai, Ai, Ai, Ai, Gd, Gd^Efm, Gd^Efm, Gd^Efm, Ai, Gd^Efm, Gll, Ai, Uu^Vud, Ms, Xu, Uh, Rb, Re, Rb, Xu, Uh^Em, Uu^Vu, Xu, Xu, Ms, Ms^Xm, Ms^Xm
Ms^Xm, Ms, Ms^Xm, Ms^Xm, Ms^Xm, Ms, Ms, Ms, Ms, Ai, Ai, Rb, Ai, Ai, Ai, Ai, Uh, Ai, Uh, Ai, Ai, Gd, Ai, Gd^Efm, Gd, Re, Re, Re, Re, Uu, Ms, Ms, Uu, Rb, Re, Re, Re^Em, Uh, Uu^Tf, Xu, Ms, Ms^Xm, Ms^Xm, Mm
Ms^Xm, Ms^Xm, Ms, Ms^Xm, Ms, Ms, Uh, Ai, Ai, Ai, Xu, Rb^Em, Rb, Ai, Xu, Xu, Xu, Uh^Em, Uh^Em, Uh, Uh, Uh, Gd, Gd, Xu, Gd, Ai, Re, Xu, Re, Re, Uu, Re, Re, Uh, Re^Em, Xu, Uh^Emf, Ms, Ms, Ms^Xm, Ms^Xm, Ms^Xm, Ms^Xm
Ms^Xm, Ms, Ms, Ms, Uh, Uh, Ai, Ai, Ai, Ai, Xu, Re, Re, Re, Xu, Xu, Xu, Uh^Tf, Gll^Em, Uh, Gd, Rb, Rb^Em, Rb^Em, Xu, Xu, Ai, Xu, Xu, Xu, Re, Re, Rb^Es, Uh, Uh^Emf, Uh^Emf, Xu, Xu, Ms, Ms, Ms^Xm, Ms^Xm, Ms^Xm, Ms^Xm
Ms^Xm, Ms, Ms, Rr^Vd, Rb, Ai, Ai, Ai, Ai, Xu, Xu, Xu, Cud, Re, Rb, Xu, Rb, Rb^Em, Rb^Es, Gll, Gd^Es, Rb, Rb, Re, Re, Rb, Re, Re, Re, Uu, Re, Re, Rb^Es, Uu^Vud, Ms, Xu, Ms, Xu, Ms, Ms, Ms^Xm, Ms^Xm, Ms^Xm, Mm
Ms, Ms^Xm, Ms, Uh, Uh, Rb, Ai, Ai, Rb, Ai, Xu, Xu, Xu, Xu, Ai, Rb^Em, Xu, Xu, Gd, Rb, Gd, Ai, Re, Re, Re, Re, Ai, Uu, Uh^Em, Re, Re, Re, Rb, Ms, Ms, Ms, Ms^Xm, Ms, Ms^Xm, Ms, Ms^Xm, Ms, Ms^Xm, Ms^Xm
Ms^Xm, Ms^Xm, Ms^Xm, Ms, Ms, Ai, Ai, Ai, Rb^Es, Rb^Es, Rr^Vd, Xu, Ai, Xu, Ai, Xu, Xu, Xu, Ai, Gd, Ai, Ai, Ai, Re, Ai, Uu, Ai, Uu^Vud, Ai, Uh^Tf, Rb, Re, Re, Uu, Ai, Ms, Ms, Ms^Xm, Ms, Ms^Xm, Ms, Ms, Ms^Xm, Ms
Ms^Xm, Ms^Xm, Ms, Ms, Qlf, Ms, Uu, Uu, Rb, Rb, Rb, Xu, Ai, Ai, Xu, Xu, Xu, Ai, Ai, Ai, Xu, Ai, Xu, Ai, Ai, Ai, Ai, Ai, Ai, Ai, Uu, Uu, Uu, Uu, Ai, Ms, Ms, Ms, Ms, Ms, Ms^Xm, Ms^Xm, Ms^Xm, Ms
Ms^Xm, Ms, Rr^Vd, Uh, Qlf, Qlf, Qlf, Qlf, Qlf, Qlf, Qlf, Rb, Rb, Ai, Rr^Vd, Xu, Xu, Ai, Ai, Xu, Uu^Vu, Xu, Uh, Uh, Uh, Gll, Gll, Ai, Gd^Es, Gd^Es, Gd, Rb, Rb^Es, Ai, Ai, Ai, Uh, Ms, Ms, Ms, Ms^Xm, Ms^Xm, Ms^Xm, Ms
Ms^Xm, Ms, Uh, Qlf, Qlf, Qlf, Qlf, 4 Kud, Cud, Cud, Cud, Qlf, Rb, Ai, Rb, Xu, Uh, Ai, Uu^Es, Ai, Uh, Uh, Uh, Uh, Uu, Uh, Rb, Gd, Gd, Rb, Rb, Rb, Rb, Rb, Xu, Ai, Uh, Ms, Ms^Xm, Ms^Xm, Ms, Ms, Ms^Xm, Ms
Ms^Xm, Ms^Xm, Mv, Uh, Ms, Uu, Uu, Rb, Cud, Xu, Cud, Rb, Uu, Rb^Es, Rb^Es, Rb, Rb, Uu^Es, Ai, Rb, Uh, Rb, Uu^Es, Gd, Gd^Efm, Gd, Gd^Efm, Gd^Efm, Gd^Efm, Gd, Rb, Rb, Uh, Re, Gd, Ai, Rb^Es, Uh, Ms, Ms^Xm, Ms^Xm, Ms^Xm, Ms, Ms
Ms^Xm, Ms^Xm, Ms^Xm, Ms^Xm, Ms, Uu, Rb, Rb, Qlf, Cud, Qlf, Rb, Rb, Uh, Uh, Ai, Uu^Es, Uu^Es, Uh, Rb, Rb, Xu, Gd^Efm, Gd, Gd, 5 Gd^Efm, Gd, Gd, Gd, Rb, Uh^Em, Uu, Uu, Gd^Efm, Gd^Es, Re, Uh, Uh, Ms, Ms, Ms, Ms^Xm, Ms, Ms
Ms^Xm, Ms^Xm, Ms, Ms, Ms, Rr^Vd, Rb, Uu, Qlf, Qlf, Qlf, Qlf, Uu, Ai, Xu, Xu, Ai, Uu^Es, Rb, Rb, Rb, Xu, Gd^Efm, Gd^Efm, Gd^Efm, Gd^Efm, Gd, Gd^Efm, Gd, Uh^Emf, Uh^Tf, Xu, Uh, Rb, Gd, Gd^Efm, Uh, Ms, Ms, Ms, Ms, Ms^Xm, Ms^Xm, Ms^Xm
Ms, Ms^Xm, Ms^Xm, Ms, Ms, Ms, Ms^Xm, Ms, Ms^Xm, Qlf, Xu, Uu, Xu, Rr^Vd, Xu, Xu, Xu, Ai, Rb, Xu, Rb, Gd, Gd^Es, Gd, Gll, Gd^Efm, Gll^Es, Rb, Uu^Vu, Uh^Emf, Uh^Tf, Xu, Xu, Uh, Uu, Rb, Uu, Uh, Ms, Ms, Ms, Ms^Xm, Ms^Xm, Ms^Xm
Ms, Ms^Xm, Ms^Xm, Ms^Xm, Ms, Ms^Xm, Ms, Ms^Xm, Mv, Ms, Ms, Xu, Xu, Xu, Xu, Xu, Xu, Uh, Uh, Rb, Gd, Gd, Ai, Gd, Ai, Gll, Uh, Uh, Xu, Xu, Xu, Xu, Uu^Vu, Xu, Uh, Uu, Rb, Uh, Cud, Ms, Ms, Ms^Xm, Ms^Xm, Md
Ms^Xm, Ms^Xm, Ms^Xm, Ms^Xm, Ms^Xm, Ms, Ms, Ms^Xm, Ms^Xm, Ms^Xm, Ms, Xu, Xu, Xu, Xu, Xu, Uh, Uh, Rb, Rb, Xu, Gd, Ai, Ai, Ai, Ai, Ai, Ai, Ai, Ai, Ai, Ai, Ai, Uh, Ai, Rb, Uh, Cud, Kud, Cud, Ms^Xm, Ms, Ms^Xm, Md
Ms^Xm, Ms^Xm, Ms^Xm, Ms^Xm, Ms^Xm, Ms^Xm, Ms, Ms^Xm, Ms, Ms^Xm, Ms, Ms, Uh^Tf, Xu, Xu, Xu, Uh, Uh, Rb, Uu, Xu, Ai, Ai, Ai, Ai, Ai, Ai, Ai, Ai, Ai, Ai, Ai, Ai, Ai, Ai, Ai, Ms, Cud, Ms, Ms, Ms^Xm, Ms, Ms^Xm, Md
Ms^Xm, Ms^Xm, Ms^Xm, Ms^Xm, Ms^Xm, Ms^Xm, Ms, Ms, Ms, Ms, Uh, Uh, Uh^Em, Uh^Em, Gll, Gll, Uu^Es, Re, Re, Re, Uh, Ai, Ai, Ms, Ms, Ai, Ai, Ai, Ai, Ai, Ai, Ai, Ai, Ms, Ms, Ms, Ms, Ms, Ms, Ms^Xm, Ms^Xm, Ms^Xm, Ms^Xm, Md
Ms^Xm, Ms^Xm, Ms^Xm, Ms^Xm, Ms, Ms^Xm, Ms^Xm, Ms, Ms, Uh, Gll, Gll, Gd, Gll, Re, Re^Es, Re, Re^Es, Uh^Em, Re, Ai, Ai, Ms, Ms, Ms^Xm, Ms, Ms, Ms, Ms, Ms, Ms, Ai, Ms, Ms, Ms, Ms^Xm, Ms^Xm, Ms^Xm, Ms^Xm, Ms^Xm, Ms^Xm, Ms^Xm, Ms^Xm, Md
Ms^Xm, Ms^Xm, Ms^Xm, Ms^Xm, Ms^Xm, Ms^Xm, Ms, Ms, Uu^Vud, Uh, Gd, Re, Re, Re, Gd, Re, Uh, Gd^Em, Uh^Tf, Uh^Em, Ms, Ms, Ms, Ms^Xm, Ms^Xm, Ms^Xm, Ms, Ms, Ms^Xm, Ms, Ms^Xm, Ms, Ms, Ms^Xm, Ms^Xm, Ms^Xm, Ms^Xm, Ms^Xm, Ms^Xm, Ms^Xm, Ms^Xm, Ms^Xm, Ms^Xm, Ms^Xm
Ms^Xm, Ms^Xm, Ms, Ms, Ms, Ms^Xm, Ms, Ms, Ms, Gll, Rb, Re, Re, Gd, Gll, Uh^Es, Uh^Em, Uh^Em, Uh^Tf, Uh^Em, Ms, Ms^Xm, Ms^Xm, Ms, Ms, Ms^Xm, Ms^Xm, Ms, Ms^Xm, Ms^Xm, Ms^Xm, Ms, Ms^Xm, Ms, Ms, Ms^Xm, Ms^Xm, Ms^Xm, Ms^Xm, Ms^Xm, Ms^Xm, Ms^Xm, Ms^Xm, Ms^Xm
Ms^Xm, Ms^Xm, Ms^Xm, Ms, Ms, Ms, Uh, Uh, Rb^Es, Gll^Es, Rb, Re, Gd, Gll, Uh, Uh^Es, Ms, Uh^Tf, Ms, Ms, Ms, Ms, Ms^Xm, Ms^Xm, Ms^Xm, Ms^Xm, Ms^Xm, Ms^Xm, Ms^Xm, Ms^Xm, Ms^Xm, Ms^Xm, Ms^Xm, Ms^Xm, Ms^Xm, Ms^Xm, Ms^Xm, Ms^Xm, Ms^Xm, Ms^Xm, Ms^Xm, Ms^Xm, Ms^Xm, Ms^Xm
Ms^Xm, Ms^Xm, Ms^Xm, Ms, Ms, Ms, Uh, Gll^Es, Re, Re, Re, Re, Rb, Ms, Ms, Ms, Ms^Xm, Ms, Ms^Xm, Ms, Ms^Xm, Ms, Ms^Xm, Ms^Xm, Ms^Xm, Ms^Xm, Ms^Xm, Ms^Xm, Ms^Xm, Ms^Xm, Ms^Xm, Ms^Xm, Ms^Xm, Ms^Xm, Ms^Xm, Ms^Xm, Ms^Xm, Ms^Xm, Ms^Xm, Ms^Xm, Ms^Xm, Ms^Xm, Ms^Xm, Ms^Xm
Mm, Ms^Xm, Ms, Ms, Ms, Ms, Uu, Re, Uu, Re, Re, Re, Uu, Ms, Ms, Ms^Xm, Mm, Ms^Xm, Mm, Ms^Xm, Ms^Xm, Ms^Xm, Ms^Xm, Ms^Xm, Ms^Xm, Ms^Xm, Ms^Xm, Ms^Xm, Ms^Xm, Ms^Xm, Ms^Xm, Ms^Xm, Ms^Xm, Ms^Xm, Mm, Ms^Xm, Ms^Xm, Ms^Xm, Ms^Xm, Ms^Xm, Ms^Xm, Ms^Xm, Mm, Ms^Xm
