border_size=1
usage=map

Re, Re, Re, Gd, Gd, Gd, Gll, Uh, Uh, Mm, Mm, Uu, Mm, Uu, Mm^Xm, Mm^Xm, Mm^Xm, Mm^Xm, Mm, Mm^Xm, Mm^Xm, Mm, Mm, Mm, Mm^Xm, Mm, Mm^Xm, Mm, Mm^Xm, Mm, Mm^Xm, Mm, Mm^Xm, Mm, Mm^Xm, Mm, Mm^Xm, Mm, Mm^Xm, Mm, Mm, Mm, Mm^Xm, Mm
Re, Re, 2 Re, Re, Re, Gll, Gll, Uh, Uh, Uh, Uh, Mm, Mm, Mm^Xm, Mm, Mm, Mm^Xm, Mm^Xm, Mm^Xm, Mm, Mm^Xm, Mm^Xm, Mm^Xm, Mm^Xm, Mm^Xm, Mm^Xm, Mm^Xm, Mm^Xm, Mm^Xm, Mm^Xm, Mm, Mm^Xm, Mm^Xm, Mm^Xm, Mm^Xm, Mm, Mm^Xm, Mm^Xm, Mm^Xm, Mm^Xm, Mm^Xm, Mm^Xm, Mm^Xm, Mm^Xm
Re, Re, Re, Re, Re, Gd^Efm, Gll, Rb, Uh, Rb, Uh, Mm, Mm, Mm, Mm^Xm, Mm^Xm, Mm, Mm^Xm, Mm, Mm^Xm, Mm, Mm, Mm, Mm^Xm, Mm^Xm, Mm^Xm, Mm, Mm^Xm, Mm^Xm, Mm^Xm, Mm^Xm, Mm^Xm, Mm^Xm, Mm^Xm, Mm^Fp, Mm^Xm, Mm^Xm, Mm^Xm, Mm^Xm, Mm^Xm, Mm^Xm, Mm^Xm, Mm^Xm, Mm^Xm
Gd, Gll, Gll^Efm, Re, Rb, Re, Re, Re, Re, Rb, Rb, Uh, Mm, Mm, Mm^Xm, Mm^Xm, Cud, Mm, Mm, Mm, Mm, Uh^Em, Mm, Mm, Mm, Mm, Mm, Mm, Mm, Mm, Mm, Mm^Xm, Mm^Xm, Mm^Xm, Mm, Mm^Fp, Mm^Fp, Mm, Mm^Fp, Mm, Mm, Mm^Xm, Mm^Xm, Mm
Uh, Gll, Gll, Gd^Efm, Rb, Rb^Es, Rb, Re, Re, Gd, Gd, Gll, Rb, Mm^Xm, Ai, Cud, Kud, Cud, Re, Mm, Gll, Uh^Em, Uh^Em, Uh^Uf, Uh^Uf, Uh^Uf, Mm, Mm, Mm, Mm, Mm, Mm, Mm, Mm, Mm^Fp, Mm^Fp, Ai, Mm^Fp, Ai, Mm^Fp, Mm, Mm^Xm, Mm^Xm, Mm^Xm
Uh, Gll, Uh, Gd, Uh, Rb^Es, Rb, Re, Gd, 1 Re, Re, Gd^Efm, Ai, Ai, Ai, Cud, Uu^Dr, Re, Gd^Efm, Gd, Rb, Gd, Rb, Gd^Emf, Gd^Emf, Uh^Emf, Mm, Cud, Mm, Cud, Mm, Mm, Mm, Mm, Mm, Ai, Ai, Ai, Ai, Ai, Mm, Mm, Mm^Xm, Mm^Xm
Mm, Uh, Uh, Gd, Uh, Uh, Rb, Gd^Efm, Gd, Re, Re, Gd, Re, Re, Re, Uu^Dr, Re, Gd, Gd, Rb, Rb^Es, Rb^Es, Gd, Rb, Gd, Gd, Re^Es, Re, Uh^Emf, Uh^Uf, Uh^Uf, Mm, Mm, Uu^Vud, Gll, Ai, Ai, Ai, Ai, Ai, Mm, Mm, Mm^Xm, Mm^Xm
Mm, Mm, Uh, Xu, Uh^Emf, Uh, Uh, Uh, Uh, Gll, Ai, Gd, Gd^Dr, Re, Ai, Re, Re, Re, Xu, Gd, Gd^Efm, Gd, Gd^Efm, Gd^Efm, Gd^Efm, Gd^Efm, Gd, Re^Es, Uh^Em, Uh^Emf, Uh^Em, Uh^Em, Gd, Gll, Ai, Ai, Xu, Ai, Ai, Ai, Ai, Mm, Mm, Mm^Xm
Mm, Mm, Mm, Uh^Emf, Mm, Uh^Emf, Mm, Uh, Mm, Mm, Ai, Gll, Uh, Rb, Gd^Dr, Gd^Dr, Cud, Rb, Rb, Gd, Gd, Gd^Efm, Gd^Efm, Gd^Efm, Gd^Efm, Gd^Efm, Gd^Efm, Gd, Gd, Uu^Em, Gd^Efm, Gd, Gd^Es, Rb, Ai, Ai, Uu^Em, Cud, Kud, Ai, Ai, Ai, Mm, Mm
Mm^Xm, Mm^Xm, Mm^Xm, Mm, Mm, Mm, Mm, Mm, Mm, Mm^Xm, Mm^Xm, Uh, Uh^Emf, Uh, Gd^Dr, Cud, Cud, Uh, Uh, Gd, Gd^Vud, Gd, Gd, Gd, Re, Gd, Re, Gd, Gd, Gd, Gd^Efm, Gd, Ai, Gd^Efm, Cud, Re^Es, Re, Cud, Cud, Xu, Ai, Ai, Mm, Mm
Mm^Xm, Mm^Xm, Mm^Xm, Mm, Mm, Mm, Mm^Xm, Mm, Mm^Xm, Mm^Xm, Mm, Mm, Mm, Uh^Em, Mm, Mm, Mm, Cud, Mm, Uh, Gd, Xu, Xu, Xu, Xu, Re, Uh, Re, Gd, Gd, Gll^Es, Ai, Gd, Gd^Efm, Uu^Dr, Ai, Re, Re, Rb, Xu, Ai, Ai, Mm, Mm
Mm^Xm, Mm^Xm, Mm, Mm^Xm, Mm^Xm, Mm^Xm, Mm^Xm, Mm^Xm, Mm^Xm, Mm, Mm, Mm, Mm, Mm, Mm, Mm, Mm, Mm, Mm^Xm, Uh^Emf, Mm, Uh^Em, Uh, Xu, Uh^Emf, Uh^Emf, Uh^Uf, Re, Mm^Xm, Cud, Kud, Gd, Gd, Gd, Rb, Re, Re, Rb, Gll^Es, Gd, Ai, Ai, Ai, Mm
Mm^Xm, Mm^Xm, Mm^Xm, Mm^Xm, Mm, Mm^Xm, Mm^Xm, Mm^Xm, Mm, Mm^Xm, Mm^Xm, Mm^Xm, Mm^Xm, Mm^Xm, Mm^Xm, Mm^Xm, Mm^Xm, Mm^Xm, Mm, Mm^Xm, Mm^Xm, Mm, Mm^Xm, Uh, Mm, Uh^Uf, Mm^Xm, Uh^Uf, Mm^Xm, Cud, Mm^Xm, Ai, Ai, Ai, Ai, Gd, Gd^Efm, Gll, Gll^Es, Ai, Ai, Ai, Ai, Mm
Mm, Mm^Xm, Mm^Xm, Mm^Xm, Mm, Mm^Xm, Mm, Mm, Mm, Mm, Mm, Mm, Mm, Mm^Xm, Mm, Mm^Xm, Mm, Mm, Uh, Mm, Mm, Mm^Xm, Mm^Fp, Mm^Xm, Mm^Xm, Mm^Xm, Mm^Fp, Mm^Xm, Cud, Mm^Xm, Uu^Vu, Mm^Xm, Ai, Ai, Ai, Gd^Efm, Gd^Efm, Gd, Ai, Ai, Ai, Ai, Mm, Mm
Mm^Xm, Mm^Xm, Mm^Xm, Mm^Xm, Mm, Mm, Mm, Mm, Mm, Mm, Gll^Fp, Mm, Mm, Uu^Vud, Gd, Uh, Uh, Uh, Uh, Uh, Mm, Mm^Fp, Mm, Mm^Fp, Re^Fp, Mm, Re^Fp, Re^Fp, Re, Mm, Ai, Mm^Xm, Ai, Ai, Rb, Ai, Gd^Efm, Ai, Ai, Ai, Gll, Ai, Mm, Mm
Mm, Mm^Xm, Mm, Mm^Xm, Mm, Mm, Mm, Mm, Gll^Fp, Gll^Fp, Gll^Fp, Gll^Fp, Gll^Fp, Uh^Em, Rb, Xu, Gd, Gd, Gd^Efm, Gd, Gd, Uu^Vud, Rb, Re, Rb^Es, Re, Rb, Re, Gll, Gll, Gll, Ai, Rb, Ai, Rb, Rb^Es, Ai, Ai, Ai, Ai, Ai, Uh, Mm, Mm
Mm^Xm, Mm^Xm, Mm, Mm, Mm, Mm, Mm, Mm, Gll^Fp, Gll^Fet, Gll^Fp, Gll^Fp, Gd^Efm, Gd, Gd, Rb, Xu, Xu, Xu, Uh, Uh, Gd, Gd^Es, Rb^Es, Gd^Efm, Rb, Gd^Efm, Gd, Gd^Em, Gd, Gd^Efm, Gd, Gd^Efm, Rb, Re, Re, Ai, Ai, Ai, Ai, Uh, Uh, Mm^Xm, Mm
Mm^Xm, Mm, Mm^Xm, Mm, Mm, Mm, Mm^Xm, Mm, Gll^Fp, Gll^Fp, Gll^Fp, Gd, Gd, Gd^Efm, Gd^Efm, Xu, Xu, Cud, Uh, Uh, 3 Kud, Cud, Cud, Gd^Es, Gll, Gd^Efm, Re, Re, Re, Gd, Ai, Gd^Efm, Gd^Em, Re, Re^Vu, Ai, Ai, Re, Mm^Xm, Ai, Uh, Mm, Mm^Xm, Mm
Mm, Mm^Xm, Mm^Xm, Mm^Xm, Mm, Mm, Mm, Mm^Xm, Mm^Xm, Gll^Fp, Gll^Fp, Xu, Gd, Gd^Efm, Gd^Efm, Gll^Fp, Uh, Xu, Uh, Uh, Cud, Xu, Gll, Gll^Es, Gd, Gd, Xu, Xu, Xu, Xu, Ai, Ai, Ai, Ai, Ai, Ai, Re, Re, Mm^Xm, Mm^Xm, Mm^Xm, Mm, Mm^Xm, Mm
Mm^Xm, Mm^Xm, Mm^Xm, Mm^Xm, Mm^Xm, Mm, Mm^Xm, Mm, Mm, Mm, Gll^Fp, Xu, Gd^Efm, Rb^Es, Gll, Gd, Gd^Efm, Uh, Uh, Xu, Gd^Efm, Uu^Dr, Gd^Es, Gll, Xu, Re, Rb, Uh, Rb, Rb, Rb^Es, Uu, Mm^Xm, Mm^Xm, Ai, Ai, Re, Mm^Xm, Uh, Mm^Xm, Mm^Xm, Mm^Xm, Mm^Xm, Mm^Xm
Mm^Xm, Mm^Xm, Mm^Xm, Mm^Xm, Mm^Xm, Mm^Xm, Mm^Xm, Mm, Mm, Mm, Mm, Uh, Rb, Rb^Es, Gll, Gll, Uh, Gd, Gd, Gll, Gd, Gd, Re, Gll, Xu, Xu, Rb^Es, Rb^Es, Rb^Es, Rb^Es, Cud, Cud, Xu, Xu, Xu, Ai, Re, Rb, Rb, Xu, Xu, Mm, Mm^Xm, Mm^Xm
Mm, Mm^Xm, Mm^Xm, Mm^Xm, Mm, Mm^Xm, Mm^Xm, Mm, Mm, Uu^Vud, Urb, Urb, Gd, Rb, Ai, Uh, Xu, Ai, Xu, Xu, Rb, Re, Gd, Gd, Gd^Efm, Rb, Re, Uu^Vud, Xu, Xu, Uu^Vud, Kud, Xu, Cud, Xu, Uu^Uf, Uu^Es, Rb, Re, Uu^Es, Xu, Mm, Mm, Mm^Xm
Mm, Mm^Xm, Mm^Xm, Mm^Xm, Mm, Mm, Mm^Xm, Mm^Xm, Mm, Mm, Urb, Xu, Gd, Ai, Ai, Ai, Xu, Xu, Xu, Uu^Emf, Re, Re, Gll, Gd^Efm, Gd^Efm, Gd, Re, Uh, Mm^Xm, Xu, Mm, Xu, Uu^Vu, Uu, Xu, Uu^Uf, Uu^Es, Rb, Uu^Es, Cud, Cud, Xu, Mm^Xm, Mm^Xm
Mm, Mm, Mm, Mm, Mm, Mm, Mm^Xm, Mm^Xm, Mm, Mm, Urb, Gd, Ai, Ai, Ai, Gd, Xu, Xu, Xu, Uh^Uf, Re, Re, Re, Xu, Xu, Gd, Gd, Mm^Xm, Mm, Mm, Mm^Xm, Xu, Xu, Uh^Emf, Uh^Emf, Uh^Emf, Uu^Em, Uu, Cud, Kud, Cud, Mm, Mm^Xm, Mm^Xm
Mm, Mm, Mm, Mm, Mm^Xm, Mm^Xm, Mm^Xm, Mm^Xm, Mm, Cud, Mm, Gd, Gll, Ai, Ai, Gd, Gd, Gll, Ai, Xu, Ai, Re, Gd^Efm, Re, Ai, Ai, Gd, Ai, Gll, Mm, Mm^Xm, Xu, Mm, Xu, Rb^Em, Uu^Em, Uu, Uu^Em, Uh^Emf, Xu, Xu, Mm, Mm^Xm, Mm^Xm
Mm^Xm, Mm, Mm^Xm, Mm^Xm, Mm^Xm, Mm^Xm, Mm, Mm, Mm, Mm, Ai, Mm, Gll, Ai, Ai, Ai, Ai, Ai, Ai, Ai, Ai, Gd, Gd^Efm, Gd^Efm, Gd^Efm, Ai, Gd^Efm, Gll, Ai, Uu^Vud, Mm, Xu, Uh, Rb, Re, Rb, Xu, Uh^Em, Uu^Vu, Xu, Xu, Mm, Mm^Xm, Mm^Xm
Mm^Xm, Mm, Mm^Xm, Mm^Xm, Mm^Xm, Mm, Mm, Mm, Mm, Ai, Ai, Rb, Ai, Ai, Ai, Ai, Uh, Ai, Uh, Ai, Ai, Gd, Ai, Gd^Efm, Gd, Re, Re, Re, Re, Uu, Mm, Mm, Uu, Rb, Re, Re, Re^Em, Uh, Uu^Uf, Xu, Mm, Mm^Xm, Mm^Xm, Mm
Mm^Xm, Mm^Xm, Mm, Mm^Xm, Mm, Mm, Uh, Ai, Ai, Ai, Xu, Rb^Em, Rb, Ai, Xu, Xu, Xu, Uh^Em, Uh^Em, Uh, Uh, Uh, Gd, Gd, Xu, Gd, Ai, Re, Xu, Re, Re, Uu, Re, Re, Uh, Re^Em, Xu, Uh^Emf, Mm, Mm, Mm^Xm, Mm^Xm, Mm^Xm, Mm^Xm
Mm^Xm, Mm, Mm, Mm, Uh, Uh, Ai, Ai, Ai, Ai, Xu, Re, Re, Re, Xu, Xu, Xu, Uh^Uf, Gll^Em, Uh, Gd, Rb, Rb^Em, Rb^Em, Xu, Xu, Ai, Xu, Xu, Xu, Re, Re, Rb^Es, Uh, Uh^Emf, Uh^Emf, Xu, Xu, Mm, Mm, Mm^Xm, Mm^Xm, Mm^Xm, Mm^Xm
Mm^Xm, Mm, Mm, Rr^Vd, Rb, Ai, Ai, Ai, Ai, Xu, Xu, Xu, Cud, Re, Rb, Xu, Rb, Rb^Em, Rb^Es, Gll, Gd^Es, Rb, Rb, Re, Re, Rb, Re, Re, Re, Uu, Re, Re, Rb^Es, Uu^Vud, Mm, Xu, Mm, Xu, Mm, Mm, Mm^Xm, Mm^Xm, Mm^Xm, Mm
Mm, Mm^Xm, Mm, Uh, Uh, Rb, Ai, Ai, Rb, Ai, Xu, Xu, Xu, Xu, Ai, Rb^Em, Xu, Xu, Gd, Rb, Gd, Ai, Re, Re, Re, Re, Ai, Uu, Uh^Em, Re, Re, Re, Rb, Mm, Mm, Mm, Mm^Xm, Mm, Mm^Xm, Mm, Mm^Xm, Mm, Mm^Xm, Mm^Xm
Mm^Xm, Mm^Xm, Mm^Xm, Mm, Mm, Ai, Ai, Ai, Rb^Es, Rb^Es, Rr^Vd, Xu, Ai, Xu, Ai, Xu, Xu, Xu, Ai, Gd, Ai, Ai, Ai, Re, Ai, Uu, Ai, Uu^Vud, Ai, Uh^Uf, Rb, Re, Re, Uu, Ai, Mm, Mm, Mm^Xm, Mm, Mm^Xm, Mm, Mm, Mm^Xm, Mm
Mm^Xm, Mm^Xm, Mm, Mm, Qlf, Mm, Uu, Uu, Rb, Rb, Rb, Xu, Ai, Ai, Xu, Xu, Xu, Ai, Ai, Ai, Xu, Ai, Xu, Ai, Ai, Ai, Ai, Ai, Ai, Ai, Uu, Uu, Uu, Uu, Ai, Mm, Mm, Mm, Mm, Mm, Mm^Xm, Mm^Xm, Mm^Xm, Mm
Mm^Xm, Mm, Rr^Vd, Uh, Qlf, Qlf, Qlf, Qlf, Qlf, Qlf, Qlf, Rb, Rb, Ai, Rr^Vd, Xu, Xu, Ai, Ai, Xu, Uu^Vu, Xu, Uh, Uh, Uh, Gll, Gll, Ai, Gd^Es, Gd^Es, Gd, Rb, Rb^Es, Ai, Ai, Ai, Uh, Mm, Mm, Mm, Mm^Xm, Mm^Xm, Mm^Xm, Mm
Mm^Xm, Mm, Uh, Qlf, Qlf, Qlf, Qlf, 4 Kud, Cud, Cud, Cud, Qlf, Rb, Ai, Rb, Xu, Uh, Ai, Uu^Es, Ai, Uh, Uh, Uh, Uh, Uu, Uh, Rb, Gd, Gd, Rb, Rb, Rb, Rb, Rb, Xu, Ai, Uh, Mm, Mm^Xm, Mm^Xm, Mm, Mm, Mm^Xm, Mm
Mm^Xm, Mm^Xm, Mv, Uh, Mm, Uu, Uu, Rb, Cud, Xu, Cud, Rb, Uu, Rb^Es, Rb^Es, Rb, Rb, Uu^Es, Ai, Rb, Uh, Rb, Uu^Es, Gd, Gd^Efm, Gd, Gd^Efm, Gd^Efm, Gd^Efm, Gd, Rb, Rb, Uh, Re, Gd, Ai, Rb^Es, Uh, Mm, Mm^Xm, Mm^Xm, Mm^Xm, Mm, Mm
Mm^Xm, Mm^Xm, Mm^Xm, Mm, Mm, Uu, Rb, Rb, Qlf, Cud, Qlf, Rb, Rb, Uh, Uh, Ai, Uu^Es, Uu^Es, Uh, Rb, Rb, Xu, Gd^Efm, Gd, Gd, 5 Gd^Efm, Gd, Gd, Gd, Rb, Uh^Em, Uu, Uu, Gd^Efm, Gd^Es, Re, Uh, Uh, Mm, Mm, Mm, Mm^Xm, Mm, Mm
Mm^Xm, Mm^Xm, Mm, Mm, Mm, Rr^Vd, Rb, Uu, Qlf, Qlf, Qlf, Qlf, Uu, Ai, Xu, Xu, Ai, Uu^Es, Rb, Rb, Rb, Xu, Gd^Efm, Gd^Efm, Gd^Efm, Gd^Efm, Gd, Gd^Efm, Gd, Uh^Emf, Uh^Uf, Xu, Uh, Rb, Gd, Gd^Efm, Uh, Mm, Mm, Mm, Mm, Mm^Xm, Mm^Xm, Mm^Xm
Mm, Mm^Xm, Mm^Xm, Mm, Mm, Mm, Mm^Xm, Mm, Mm^Xm, Qlf, Xu, Uu, Xu, Rr^Vd, Xu, Xu, Xu, Ai, Rb, Xu, Rb, Gd, Gd^Es, Gd, Gll, Gd^Efm, Gll^Es, Rb, Uu^Vu, Uh^Emf, Uh^Uf, Xu, Xu, Uh, Uu, Rb, Uu, Uh, Mm, Mm, Mm, Mm^Xm, Mm^Xm, Mm^Xm
Mm, Mm^Xm, Mm^Xm, Mm^Xm, Mm, Mm^Xm, Mm, Mm^Xm, Mv, Mm, Mm, Xu, Xu, Xu, Xu, Xu, Xu, Uh, Uh, Rb, Gd, Gd, Ai, Gd, Ai, Gll, Uh, Uh, Xu, Xu, Xu, Xu, Uu^Vu, Xu, Uh, Uu, Rb, Uh, Cud, Mm, Mm, Mm^Xm, Mm^Xm, Mm
Mm^Xm, Mm^Xm, Mm^Xm, Mm^Xm, Mm^Xm, Mm, Mm, Mm^Xm, Mm^Xm, Mm^Xm, Mm, Xu, Xu, Xu, Xu, Xu, Uh, Uh, Rb, Rb, Xu, Gd, Ai, Ai, Ai, Ai, Ai, Ai, Ai, Ai, Ai, Ai, Ai, Uh, Ai, Rb, Uh, Cud, Kud, Cud, Mm^Xm, Mm, Mm^Xm, Mm
Mm^Xm, Mm^Xm, Mm^Xm, Mm^Xm, Mm^Xm, Mm^Xm, Mm, Mm^Xm, Mm, Mm^Xm, Mm, Mm, Uh^Uf, Xu, Xu, Xu, Uh, Uh, Rb, Uu, Xu, Ai, Ai, Ai, Ai, Ai, Ai, Ai, Ai, Ai, Ai, Ai, Ai, Ai, Ai, Ai, Mm, Cud, Mm, Mm, Mm^Xm, Mm, Mm^Xm, Mm
Mm^Xm, Mm^Xm, Mm^Xm, Mm^Xm, Mm^Xm, Mm^Xm, Mm, Mm, Mm, Mm, Uh, Uh, Uh^Em, Uh^Em, Gll, Gll, Uu^Es, Re, Re, Re, Uh, Ai, Ai, Mm, Mm, Ai, Ai, Ai, Ai, Ai, Ai, Ai, Ai, Mm, Mm, Mm, Mm, Mm, Mm, Mm^Xm, Mm^Xm, Mm^Xm, Mm^Xm, Mm
Mm^Xm, Mm^Xm, Mm^Xm, Mm^Xm, Mm, Mm^Xm, Mm^Xm, Mm, Mm, Uh, Gll, Gll, Gd, Gll, Re, Re^Es, Re, Re^Es, Uh^Em, Re, Ai, Ai, Mm, Mm, Mm^Xm, Mm, Mm, Mm, Mm, Mm, Mm, Ai, Mm, Mm, Mm, Mm^Xm, Mm^Xm, Mm^Xm, Mm^Xm, Mm^Xm, Mm^Xm, Mm^Xm, Mm^Xm, Mm
Mm^Xm, Mm^Xm, Mm^Xm, Mm^Xm, Mm^Xm, Mm^Xm, Mm, Mm, Uu^Vud, Uh, Gd, Re, Re, Re, Gd, Re, Uh, Gd^Em, Uh^Uf, Uh^Em, Mm, Mm, Mm, Mm^Xm, Mm^Xm, Mm^Xm, Mm, Mm, Mm^Xm, Mm, Mm^Xm, Mm, Mm, Mm^Xm, Mm^Xm, Mm^Xm, Mm^Xm, Mm^Xm, Mm^Xm, Mm^Xm, Mm^Xm, Mm^Xm, Mm^Xm, Mm^Xm
Mm^Xm, Mm^Xm, Mm^Fp, Mm^Fp, Mm^Fp, Mm^Xm, Mm, Mm, Mm, Gll, Rb, Re, Re, Gd, Gll, Uh^Es, Uh^Em, Uh^Em, Uh^Uf, Uh^Em, Mm, Mm^Xm, Mm^Xm, Mm, Mm, Mm^Xm, Mm^Xm, Mm, Mm^Xm, Mm^Xm, Mm^Xm, Mm, Mm^Xm, Mm, Mm, Mm^Xm, Mm^Xm, Mm^Xm, Mm^Xm, Mm^Xm, Mm^Xm, Mm^Xm, Mm^Xm, Mm^Xm
Mm^Xm, Mm^Xm, Mm^Xm, Mm^Fp, Mm^Fp, Mm^Fp, Uh, Uh, Rb^Es, Gll^Es, Rb, Re, Gd, Gll, Uh, Uh^Es, Mm, Uh^Uf, Mm, Mm, Mm, Mm, Mm^Xm, Mm^Xm, Mm^Xm, Mm^Xm, Mm^Xm, Mm^Xm, Mm^Xm, Mm^Xm, Mm^Xm, Mm^Xm, Mm^Xm, Mm^Xm, Mm^Xm, Mm^Xm, Mm^Xm, Mm^Xm, Mm^Xm, Mm^Xm, Mm^Xm, Mm^Xm, Mm^Xm, Mm^Xm
Mm^Xm, Mm^Xm, Mm^Xm, Mm^Fp, Mm, Mm, Uh, Gll^Es, Re, Re, Re, Re, Rb, Mm, Mm, Mm, Mm^Xm, Mm, Mm^Xm, Mm, Mm^Xm, Mm, Mm^Xm, Mm^Xm, Mm^Xm, Mm^Xm, Mm, Mm^Xm, Mm^Xm, Mm^Xm, Mm^Xm, Mm^Xm, Mm^Xm, Mm^Xm, Mm^Xm, Mm^Xm, Mm^Xm, Mm^Xm, Mm^Xm, Mm^Xm, Mm^Xm, Mm^Xm, Mm^Xm, Mm^Xm
Mm, Mm^Xm, Mm, Mm, Mm, Mm, Uu, Re, Uu, Re, Re, Re, Uu, Mm, Mm, Mm^Xm, Mm, Mm^Xm, Mm, Mm^Xm, Mm^Xm, Mm^Xm, Mm^Xm, Mm^Xm, Mm^Xm, Mm^Xm, Mm^Xm, Mm, Mm^Xm, Mm^Xm, Mm^Xm, Mm^Xm, Mm^Xm, Mm^Xm, Mm, Mm^Xm, Mm^Xm, Mm^Xm, Mm^Xm, Mm^Xm, Mm^Xm, Mm^Xm, Mm, Mm^Xm
