Ms, Ms, Ms, Ms, Ms, Ms, Ms, Re, Ha^Esa, Ha, Ha, Ha, Ha^Fpa, Ha, Ha, Re, Ha, Ha, Ha, Ha, Ms, Ms^Fpa, Ms, Ha^Fpa, Ms, Ha^Fpa, Xu, Xu, Xu, Xu
Ms, Ms, Ms, Ms, Ms, Ms, Ms, Ha^Esa, Re, Ha, Ha^Esa, Ha^Fda, Ha^Fda, Ha^Fda, Ha, Ha^Esa, Ha^Esa, Ha^Fda, Ha^Fma, Ms, Ms, Ms, Ms, Ms, Ms, Ms, Xu, Xu, Xu, Xu
Ms, Ms, Ms, Ms, Ha^Fda, Ms, Ha^Es, Ha^Vca, Re^Es, Ha^Esa, Ha^Esa, Ha, Ha^Fma, Ha^Fma, Ha^Fda, Ha^Esa, Ha, Ha, Ha^Esa, Ha^Esa, Ha^Vca, Ms, Ms, Ms, Ha^Fma, Xu, Xu, Xu, Xu, Xu
Ms, Ms, Ms, Ms, Ha, Re^Es, Re, Rd, Rd^Es, Ha, Ha, Ha^Esa, Ha, Ha^Fpa, Ha^Esa, Ha, Re, Re, Rd^Es, Rd^Es, Ha, Ha, Ms, Ms, Xu, Xu, Ha, Ha^Fma, Ha^Fda, Xu
Ms, Ha^Fda, Ha^Fma, Ha^Fpa, Ha, Ha, Re, Re^Es, Rd, Rd, Ha^Esa, Ha, Ha, Ha^Esa, Ha^Esa, Ha, Ha, Rd, Re, Re^Es, Ha^Es, Ha^Esa, Ha^Esa, Ha, Ha^Fpa, Xu, Ha^Fpa, Ha^Fda, Ha^Fma, Xu
Re, Ha^Fpa, Ha^Fda, Ha^Fda, Ha^Fma, Ha, Re^Esa, Re^Esa, Ha, Ha^Esa, Ai, Ha, Ha, Ha^Esa, Ha, Ha, Ha, Re, Re, Re^Esa, Re^Esa, Ha, Ha, Ha^Fda, Ha^Fpa, Ha^Fda, Ha^Fda, Ha^Fpa, Xu, Xu
Ha, Ha^Esa, Ha^Esa, Ha^Fma, Aa^Fpa, Ha^Fda, Ha, Rd^Esa, Ai, Ha, Ai, Ai, Ai, Ai, Ai, Ai, Ai, Ha, Re, Re^Esa, Re, Re, Rd, Rd, Aa^Fma, Ha^Fpa, Ha, Ha^Fpa, Xu, Ha^Fpa
Ha^Esa, Ha^Esa, Rd, Re^Esa, Ms, Ha, Ha^Esa, Ha^Esa, Ai, Ai, Ai, Ai, Ai, Ai, Ai, Ai, Ai, Ai, Ai, Ai, Ai, Ai, Rd, Aa^Fpa, Aa^Fda, Aa^Fpa, Aa^Fma, Ha^Vca, Ha^Fpa, Ha^Fpa
Ha, Ha, Ha^Vca, Ms, Ms, Ms, Ha, Ha^Esa, Ai, Ai, Ai, Ai, Ai, Ai, Rd^Es, Ai, Ai, Ai, Ai, Ai, Ai, Ai, Re, Aa^Fda, Aa^Fpa, Aa^Fda, Aa^Fpa, Aa^Fda, Aa^Fda, Rd
Rd, Ha, Ha^Esa, Ha, Ms, Re, Re^Esa, Ai, Ai, Ai, Ha^Fpa, Ha^Fpa, Aa^Fpa, Rd^Esa, Rd^Esa, Ai, Ai, Ai, Ai, Ai, Ai, Ai, Ai, Re, Re, Rd^Esa, Re^Esa, Aa^Fma, Rd, Re
Ha, Ha^Esa, Ha^Esa, Ms, Ha, Rd, Rd^Esa, Ai, Ai, Ai, Ai, Ha^Fpa, Ai, Ai, Ai, Ai, Ai, Ai, Ai, Ai, Ai, Ai, Ha, Ha^Esa, Re, Rd^Esa, Re^Es, Re, Rd^Es, Rd
Ha, Ha, Re^Es, Ha, Re, Rd, Ai, Ai, Ai, Ai, Ai, Ai, Ai, Ai, Ai, Ai, Ai, Ai, Ai, Ai, Ai, Ai, Ai, Ha, Ha^Esa, Re, Re, Rd, Rd^Es, Rd
Ha, Re^Es, Rd^Es, Re, Rd^Esa, Rd^Esa, Ai, Ai, Ai, Ai, Ai, Ai, Ai, Ai, Ai, Ai, Ai, Ai, Ai, Ai, Ai, Ai, Ai, Ha^Esa, Ha^Esa, Ha, Rd, Rd, Re^Es, Re
Ha^Fpa, Ha^Fpa, Re, Rd^Es, Rd, Rd^Esa, Rd, Ai, Ai, Ai, Ai, Ai, Ai, Ai, Ai, Ai, Ai, Ai, Ai, Ai, Ai, Ai, Ai, Ai, Ha, Ha, Rd^Esa, Rd^Es, Re, Re
Ha^Fpa, Ha^Fma, Ha^Fma, Re, Aa^Fma, Re, Ha, Ai, Ai, Ai, Ha^Esa, Ai, Ai, Ai, Ai, Ai, Ai, Ai, Ai, Ai, Ai, Ai, Ai, Ha^Esa, Ha^Esa, Rd, Rd^Esa, Re^Esa, Re^Es, Re
Ms, Ms, Ms, Ms, Ms, Ha^Esa, Ha, Ha^Esa, Ha^Esa, Ha, Ai, Ai, Ai, Ai, Rd, Ai, Ai, Ai, Ai, Ai, Ai, Ai, Ha, Ha^Esa, Ha, Re, Rd, Rd, Ha^Fda, Aa^Fda
Ms, Ms, Ms, Ms, Ms, Ms, Ha, Ha^Esa, Ha, Ha, Ai, Ai, Ai, Ai, Rd^Esa, Rd^Esa, Ai, Ai, Ai, Ai, Ha^Esa, Ai, Ha, Ha, Ha, Re, Re, Ha^Vca, Ha^Fma, Ha
Ms, Ms, Ms, Ms, Ms, Ha^Fpa, Ha, Ha, Ha^Esa, Ha^Esa, Rd, Ai, Rd, Rd, 2 Rd, Rd, Rd^Esa, Ai, Rd^Esa, Ha, Ha^Esa, Ha^Esa, Ha^Fma, Ha^Fpa, Ha^Fda, Ha^Fda, Ha^Fpa, Ha^Fma, Ha^Fpa, Ha
Ha^Fpa, Ha^Fma, Ms, Ms, Coa, Ms, Re, Re, Ha, Ha^Esa, Re, Rd, Rd^Esa, Rd, Re, Rd, Rd^Esa, Rd^Esa, Rd, Ha, Ha, Ha^Esa, Ha^Fda, Ha^Fma, Ha^Fpa, Ha^Fda, Ms, Ha^Fpa, Xu, Ms^Fpa
Ha, Ms, Ha^Fma, Koa, Coa, Re, Re^Esa, 1 Re^Esa, Re, Ha, Re, Re^Esa, Re^Esa, Re, Ha, Ha, Ha, Rd, Re^Es, Re^Es, Ha, Ha, Ms, Ha, Ha^Fpa, Ha^Esa, Ms, Ms, Xu, Xu
Ha, Ha^Vca, Ha^Fpa, Coa, Re, Re, Re, Re^Esa, Re, Re, Re^Esa, Re, Ha, Ha, Ha^Fma, Ms, Ms, Re, Ms, Re^Es, Ha^Vca, Ha^Fda, Ms, Ms, Ms, Ms, Ms, Xu, Xu, Xu
Rd, Ha, Ha, Ha, Re, Re^Es, Re^Es, Re, Re^Es, Re^Esa, Re, Re^Es, Re, Ha, Ha, Ms, Ms, Ms, Ms, Ms, Ha^Fpa, Ms, Ms, Ms, Ms, Ms, Ms, Xu, Xu, Ms
Rd, Rd, Rd, Ha, Re, Re, Rd, Re^Es, Re, Re^Es, Rd, Rd, Ha, Ha, Rd, Ha^Fda, Ha, Ms, Ha, Ha^Fda, Ms, Ms, Ms, Ms, Ha, Ms, Ms, Ms, Ms, Ms
