Ms, Ms, Ms, Ms, Ms, Ms, Ms, Re, Ha, Ha, Ha, Ha, Ha^Fpa, Ha, Ha, Re, Ha, Ha, Ha, Ha, Ms, Ms^Fpa, Ms, Ha^Fpa, Ms, Ha^Fpa, Xu, Xu, Xu, Xu
Ms, Ms, Ms, Ms, Ms, Ms, Ms, Ha, Re, Ha, Ha, Ha^Fpa, Ha^Fpa, Ha^Fpa, Ha, Ha, Ha, Ha^Fpa, Ha^Fpa, Ms, Ms, Ms, Ms, Ms, Ms, Ms, Xu, Xu, Xu, Xu
Ms, Ms, Ms, Ms, Ha^Fpa, Ms, Ha^Es, Ha^Vhr, Re^Es, Ha, Ha, Ha, Ha^Fpa, Ha^Fpa, Ha^Fpa, Ha, Ha, Ha, Ha, Ha, Ha^Vhr, Ms, Ms, Ms, Ha^Fpa, Xu, Xu, Xu, Xu, Xu
Ms, Ms, Ms, Ms, Ha, Re^Es, Re, Rd, Rd^Es, Ha, Ha, Ha, Ha, Ha^Fpa, Ha, Ha, Re, Re, Rd^Es, Rd^Es, Ha, Ha, Ms, Ms, Xu, Xu, Ha, Ha^Fpa, Ha^Fpa, Xu
Ms, Ha^Fpa, Ha^Fpa, Ha^Fpa, Ha, Ha, Re, Re^Es, Rd, Rd, Ha, Ha, Ha, Ha, Ha, Ha, Ha, Rd, Re, Re^Es, Ha^Es, Ha, Ha, Ha, Ha^Fpa, Xu, Ha^Fpa, Ha^Fpa, Ha^Fpa, Xu
Re, Ha^Fpa, Ha^Fpa, Ha^Fpa, Ha^Fpa, Ha, Re, Re, Ha, Ha, Ai, Ha, Ha, Ha, Ha, Ha, Ha, Re, Re, Re, Re, Ha, Ha, Ha^Fpa, Ha^Fpa, Ha^Fpa, Ha^Fpa, Ha^Fpa, Xu, Xu
Ha, Ha, Ha, Ha^Fpa, Re^Fpa, Ha^Fpa, Ha, Rd, Ai, Ha, Ai, Ai, Ai, Ai, Ai, Ai, Ai, Ha, Re, Re, Re, Re, Rd, Rd, Rd^Fpa, Ha^Fpa, Ha, Ha^Fpa, Xu, Ha^Fpa
Ha, Ha, Rd, Re, Ms, Ha, Ha, Ha, Ai, Ai, Ai, Ai, Ai, Ai, Ai, Ai, Ai, Ai, Ai, Ai, Ai, Ai, Rd, Rd^Fpa, Rd^Fpa, Re^Fpa, Re^Fpa, Ha^Vhr, Ha^Fpa, Ha^Fpa
Ha, Ha, Ha^Vhr, Ms, Ms, Ms, Ha, Ha, Ai, Ai, Ai, Ai, Ai, Ai, Rd^Es, Ai, Ai, Ai, Ai, Ai, Ai, Ai, Re, Rd^Fpa, Rd^Fpa, Rd^Fpa, Re^Fpa, Re^Fpa, Rd^Fpa, Rd
Rd, Ha, Ha, Ha, Ms, Re, Re, Ai, Ai, Ai, Ha^Fpa, Ha^Fpa, Re^Fpa, Rd, Rd, Ai, Ai, Ai, Ai, Ai, Ai, Ai, Ai, Re, Re, Rd, Re^Es, Rd^Fpa, Rd, Re
Ha, Ha, Ha, Ms, Ha, Rd, Rd, Ai, Ai, Ai, Ai, Ha^Fpa, Ai, Ai, Ai, Ai, Ai, Ai, Ai, Ai, Ai, Ai, Ha, Ha, Re, Rd, Re^Es, Re, Rd^Es, Rd
Ha, Ha, Re^Es, Ha, Re, Rd, Ai, Ai, Ai, Ai, Ai, Ai, Ai, Ai, Ai, Ai, Ai, Ai, Ai, Ai, Ai, Ai, Ai, Ha, Ha, Re, Re, Rd, Rd^Es, Rd
Ha, Re^Es, Rd^Es, Re, Rd, Rd, Ai, Ai, Ai, Ai, Ai, Ai, Ai, Ai, Ai, Ai, Ai, Ai, Ai, Ai, Ai, Ai, Ai, Ha, Ha, Ha, Rd, Rd, Re^Es, Re
Ha^Fpa, Ha^Fpa, Re, Rd^Es, Rd, Rd, Rd, Ai, Ai, Ai, Ai, Ai, Ai, Ai, Ai, Ai, Ai, Ai, Ai, Ai, Ai, Ai, Ai, Ai, Ha, Ha, Rd, Rd^Es, Re, Re
Ha^Fpa, Ha^Fpa, Ha^Fpa, Re, Rd^Fpa, Re, Ha, Ai, Ai, Ai, Ha, Ai, Ai, Ai, Ai, Ai, Ai, Ai, Ai, Ai, Ai, Ai, Ai, Ha, Ha, Rd, Rd, Re, Re^Es, Re
Ms, Ms, Ms, Ms, Ms, Ha, Ha, Ha, Ha, Ha, Ai, Ai, Ai, Ai, Rd, Ai, Ai, Ai, Ai, Ai, Ai, Ai, Ha, Ha, Ha, Re, Rd, Rd, Ha^Fpa, Re^Fpa
Ms, Ms, Ms, Ms, Ms, Ms, Ha, Ha, Ha, Ha, Ai, Ai, Ai, Ai, Rd, Rd, Ai, Ai, Ai, Ai, Ha, Ai, Ha, Ha, Ha, Re, Re, Ha^Vhr, Ha^Fpa, Ha
Ms, Ms, Ms, Ms, Ms, Ha^Fpa, Ha, Ha, Ha, Ha, Rd, Ai, Rd, Rd, 2 Rd, Rd, Rd, Ai, Rd, Ha, Ha, Ha, Ha^Fpa, Ha^Fpa, Ha^Fpa, Ha^Fpa, Ha^Fpa, Ha^Fpa, Ha^Fpa, Ha
Ha^Fpa, Ha^Fpa, Ms, Ms, Coa, Ms, Re, Re, Ha, Ha, Re, Rd, Rd, Rd, Re, Rd, Rd, Rd, Rd, Ha, Ha, Ha, Ha^Fpa, Ha^Fpa, Ha^Fpa, Ha^Fpa, Ms, Ha^Fpa, Xu, Ms^Fpa
Ha, Ms, Ha^Fpa, Koa, Coa, Re, Re, 1 Re, Re, Ha, Re, Re, Re, Re, Ha, Ha, Ha, Rd, Re^Es, Re^Es, Ha, Ha, Ms, Ha, Ha^Fpa, Ha, Ms, Ms, Xu, Xu
Ha, Ha^Vhr, Ha^Fpa, Coa, Re, Re, Re, Re, Re, Re, Re, Re, Ha, Ha, Ha^Fpa, Ms, Ms, Re, Ms, Re^Es, Ha^Vhr, Ha^Fpa, Ms, Ms, Ms, Ms, Ms, Xu, Xu, Xu
Rd, Ha, Ha, Ha, Re, Re^Es, Re^Es, Re, Re^Es, Re, Re, Re^Es, Re, Ha, Ha, Ms, Ms, Ms, Ms, Ms, Ha^Fpa, Ms, Ms, Ms, Ms, Ms, Ms, Xu, Xu, Ms
Rd, Rd, Rd, Ha, Re, Re, Rd, Re^Es, Re, Re^Es, Rd, Rd, Ha, Ha, Rd, Ha^Fpa, Ha, Ms, Ha, Ha^Fpa, Ms, Ms, Ms, Ms, Ha, Ms, Ms, Ms, Ms, Ms
