border_size=1
usage=map

Xu, Xu, Xu, Xu, Xu, Xu, Xu, Xu, Xu, Xu, Xu, Xu, Xu, Xu, Xu, Xu, Xu, Xu, Xu, Xu, Xu, Xu, Xu, Xu, Xu, Xu, Xu, Xu, Xu, Xu, Xu, Xu, Xu, Xu, Xu, Xu, Xu, Xu, Xu, Xu, Xu, Xu, Xu, Xu, Xu, Xu, Xu, Xu
Xu, Xu, Xu, Xu, Xu, Xu, Xu, Xu, Xu, Xu, Xu, Xu, Xu, Xu, Xu, Xu, Xu, Xu, Xu, Xu, Xu, Xu, Xu, Xu, Xu, Xu, Xu, Xu, Xu, Xu, Xu, Xu, Xu, Xu, Xu, Xu, Xu, Xu, Xu, Xu, Xu, Xu, Xu, Xu, Xu, Xu, Xu, Xu
Xu, Xu, Xu, Xu, Xu, Xu, Xu, Xu, Xu, Xu, Xu, Xu, Xu, Xu, Xu, Xu, Xu, Xu, Xu, Xu, Xu, Xu, Xu, Xu, Xu, Xu, Xu, Xu, Xu, Xu, Xu, Xu, Xu, Xu, Xu, Xu, Xu, Xu, Xu, Xu, Xu, Xu, Xu, Xu, Xu, Xu, Xu, Xu
Xu, Xu, Xu, Xu, Xu, Xu, Xu, Xu, Xu, Xu, Xu, Xu, Xu, Xu, Xu, Xu, Xu, Xu, Xu, Xu, Xu, Xu, Cud, Xu, Xu, Xu, Xu, Xu, Xu, Xu, Cud, Xu, Xu, Xu, Xu, Xu, Xu, Xu, Xu, Xu, Xu, Xu, Xu, Xu, Xu, Xu, Xu, Xu
Xu, Xu, Xu, Xu, Xu, Xu, Xu, Xu, Xu, Xu, Xu, Xu, Xu, Cud, Xu, Xu, Xu, Xu, Xu, Xu, Xu, Xu, Uh^Emf, Xu, Xu, Uu^Vud, Xu, Xu, Uh^Tf, Xu, Uh^Tf, Xu, Xu, Xu, Xu, Xu, Cud, Xu, Xu, Xu, Xu, Xu, Xu, Xu, Xu, Xu, Xu, Xu
Xu, Xu, Xu, Xu, Xu, Xu, Xu, Xu, Xu, Cud, Uh, Uh^Tf, Uh^Tf, Uh^Tf, Uh^Emf, Xu, Xu, Xu, Uh^Emf, Uh^Tf, Uh^Em, Uh^Tf, Xu, Uh^Emf, Uu, Uh, Rb, Uh^Em, Rb, Uh^Emf, Uu, Xu, Xu, Xu, Xu, Xu, Uh^Tf, Xu, Xu, Xu, Xu, Xu, Xu, Xu, Xu, Xu, Xu, Xu
Xu, Xu, Xu, Xu, Xu, Xu, Xu, Xu, Xu, Xu, Uu, Uh^Emf, Xu, Xu, Rb, Uh^Vud, Uu^Em, Rb, Aa, Uh^Emf, Xu, Xu, Rb, Uu, Aa, Xu, Aa, Aa, Rb, Aa, Rb^Es, Uu, Uh^Em, Uh^Tf, Uh^Emf, Uh^Tf, Uh^Emf, Xu, Xu, Xu, Xu, Xu, Xu, Xu, Xu, Xu, Xu, Xu
Xu, Xu, Xu, Xu, Xu, Xu, Xu, Xu, Xu, Xu, Xu, Rb^Em, Xu, Xu, Aa, Rb, Aa, Rb^Es, Aa, Aa, Aa, Aa, Rb^Es, Uh, Uh^Tf, Aa, Aa, Aa, Uu, Rb^Es, Aa, Aa, Aa, Uu^Em, Aa, Aa, Uh^Em, Xu, Xu, Xu, Xu, Xu, Xu, Xu, Xu, Xu, Xu, Xu
Xu, Xu, Xu, Xu, Xu, Xu, Xu, Xu, Xu, Xu, Uh, Uu^Es, Rb^Es, Aa, Aa, Aa, Aa, Aa, Uh, Aa, Rb, Rb^Es, Rb^Es, Qxu, Uh^Emf, Aa, Aa, Ai, Ai, Uh^Tf, Uh^Emf, Aa, Aa, Aa, Aa, Xu, Rb, Uh^Tf, Uh^Emf, Xu, Uh^Tf, Cud, Xu, Xu, Xu, Xu, Xu, Xu
Xu, Xu, Xu, Xu, Xu, Xu, Xu, Cud, Uh^Tf, Uh^Emf, Xu, Xu, Aa, Rb, Uh^Em, Ai, Ai, Uh^Tf, Uh^Tf, Uu, Aa, Uu^Vud, Aa, Aa, Ai, Uh, Uh^Vud, Ai, Uh, Uh^Emf, Aa, Uu^Vud, Aa, Aa, Qxu, Aa, Rb^Es, Rb^Em, Xu, Uh^Emf, Uh^Emf, Xu, Xu, Xu, Xu, Xu, Xu, Xu
Xu, Xu, Xu, Xu, Xu, Xu, Xu, Xu, Uh, Uh, Xu, Aa, Aa, Qxu, Uu^Em, Uh^Em, Uh, Uh^Emf, Rb^Es, Uh, Uu, Ai, Ai, Ai, Cud, Cud, Cud, Uu, Ai, Uh, Ai, Ai, Aa, Uh^Tf, Qxu, Rb, Rb, Aa, Aa, Aa, Uu^Vud, Xu, Xu, Xu, Xu, Xu, Xu, Xu
Xu, Xu, Xu, Xu, Xu, Xu, Uh^Tf, Uh^Tf, Uh^Emf, Uh^Em, Uh^Emf, Aa, Ai, Qxu, Ai, Uh, Aa, Uu, Ai, Rb^Es, Ai, Ai, Qxu, Uu, Cud, 3 Kud, Cud, Qxu, Ai, Ai, Ai, Ai, Ai, Rb^Vud, Rb, Qxu, Uu, Rb^Es, Rb, Rb^Es, Xu, Uh^Emf, Uh^Tf, Xu, Xu, Xu, Xu, Xu
Xu, Xu, Xu, Xu, Xu, Xu, Xu, Uh^Em, Rb, Aa, Rb^Es, Uh^Tf, Aa, Ai, Aa, Aa, Aa, Uh^Vud, Cud, Qxu, Qxu, Ai, Aa, Qxu, Qxu, Rb, Qxu, Qxu, Ai, Ai, Qxu, Qxu, Cud, Aa, Uu, Rb, Aa, Aa, Aa, Aa, Aa, Uh^Emf, Uh^Tf, Xu, Cud, Xu, Xu, Xu
Xu, Xu, Xu, Xu, Xu, Xu, Uh^Vud, Uh^Em, Xu, Xu, Qxu, Rb^Es, Rb^Em, Ai, Rb, Rb, Rb, Cud, 4 Kud, Cud, Qxu, Aa, Aa, Aa, Qxu, Uu^Xo, Qxu, Aa, Aa, Ai, Qxu, Cud, 5 Kud, Cud, Rb, Rb, Ai, Aa, Uh^Tf, Aa, Aa, Uu^Em, Uh^Emf, Uh^Tf, Xu, Xu, Xu, Xu
Xu, Xu, Xu, Cud, Uh^Tf, Uh, Xu, Uh, Xu, Aa, Qxu, Rb^Es, Rb^Es, Uu^Em, Uu^Es, Aa, Aa, Cud, Cud, Rb, Uu^Xo, Qxu, Aa, Aa, Ai, Qxu, Ai, Aa, Aa, Qxu, Uu^Xo, Rb, Cud, Cud, Uh, Rb, Rb, Uh, Aa, Rb, Rb^Es, Rb^Es, Uu^Es, Uh^Em, Xu, Xu, Xu, Xu
Xu, Xu, Xu, Xu, Xu, Rb, Xu, Aa, Aa, Aa, Rb^Es, Rb, Uu^Vud, Ai, Ai, Aa, Ai, Qxu, Qxu, Qxu, Qxu, Qxu, Ai, Aa, Ai, Ai, Ai, Aa, Ai, Qxu, Qxu, Qxu, Qxu, Qxu, Aa, Rb^Es, Uu, Ai, Ai, Ai, Rb, Aa, Uh, Uu^Vud, Xu, Xu, Xu, Xu
Xu, Xu, Xu, Uh^Tf, Uu^Emf, Rb^Es, Xu, Aa, Uh^Emf, Uh^Emf, Xu, Rb^Es, Ai, Ai, Ai, Ai, Ai, Aa, Ai, Aa, Aa, Aa, Aa, Ai, Ai, 2 Ai, Ai, Ai, Aa, Aa, Aa, Aa, Ai, Ai, Ai, Rb^Es, Uu^Vud, Rb, Aa, Aa, Aa, Uu, Xu, Uu^Es, Uh^Emf, Xu, Xu, Xu
Xu, Xu, Uh^Tf, Uh^Emf, Xu, Uh, Rb, Rb, Uu^Em, Uh^Tf, Rb, Rb, Uu, Rb, Uu, Ai, Uh, Ai, Ai, Aa, Aa, Aa, Ai, Ai, Ai, Ai, Ai, Ai, Ai, Aa, Aa, Ai, Ai, Ai, Aa, Aa, Rb, Rb^Es, Rb, Uh, Uh, Aa, Uh, Rb, Uu^Em, Uh^Emf, Uh^Tf, Xu
Xu, Xu, Xu, Uh^Emf, Xu, Xu, Rb^Es, Xu, Rb^Es, Uu^Em, Ai, Ai, Rb, Aa, Aa, Uh, Aa, Rb^Es, Qxu, Aa, Qxu, Aa, Qxu, Aa, Ai, Ai, Ai, Aa, Qxu, Aa, Qxu, Aa, Ai, Ai, Rb, Aa, Rb, Rb, Ai, Qxu, Qxu, Uu, Xu, Aa, Uh, Uh^Emf, Xu, Xu
Xu, Xu, Xu, Uh, Uu^Em, Rb^Es, Qxu, Uu^Vud, Qxu, Rb, Uh^Es, Rb, Aa, Aa, Ai, Aa, Uh, Rb^Es, Qxu, Qxu, Cud, Qxu, Uu^Xo, Qxu, Aa, Aa, Aa, Qxu, Uu^Xo, Qxu, Cud, Qxu, Rb^Es, Rb^Es, Rb^Es, Rb^Es, Rb, Uh, Ai, Aa, Qxu, Rb, Rb, Xu, Uu^Vud, Xu, Xu, Xu
Xu, Cud, Uh^Tf, Uu^Emf, Rb, Rb, Xu, Qxu, Qxu, Xu, Uh, Rb^Es, Aa, Ai, Aa, Aa, Uh, Uh^Emf, Uh^Tf, Cud, 7 Kud, Rb, Qxu, Qxu, Aa, Aa, Aa, Qxu, Qxu, Rb, 6 Kud, Cud, Uh, Uh, Uh^Vud, Ai, Uh, Uh^Tf, Ai, Aa, Aa, Qxu, Uh^Emf, Uh^Emf, Xu, Xu, Xu, Xu
Xu, Qxu, Rb^Es, Uh^Emf, Uh^Emf, Xu, Xu, Uh^Tf, Rb, Uh, Uu, Uu^Em, Uu, Aa, Ai, Aa, Uh, Ai, Ai, Cud, Cud, Cud, Qxu, Ai, Ai, Aa, Ai, Ai, Qxu, Cud, Cud, Cud, Uu, Rb^Es, Ai, Ai, Rb^Es, Uh^Emf, Uu, Aa, Xu, Xu, Uh^Tf, Uh^Tf, Xu, Xu, Xu, Xu
Xu, Qxu, Rb^Es, Qxu, Uh, Uh^Tf, Xu, Uh^Tf, Rb, Xu, Qxu, Uh, Ai, Ai, Ai, Uu^Vud, Uh, Ai, Uh, Uh, Aa, Qxu, Aa, Ai, Ai, Ai, Ai, Ai, Uh, Uu, Ai, Ai, Rb, Ai, Uh, Uh, Aa, Rb, Aa, Rb, Uh, Uh^Em, Xu, Uu^Em, Xu, Xu, Xu, Xu
Xu, Xu, Xu, Rb^Es, Rb^Es, Rb^Emf, Rb^Es, Rb^Emf, Qxu, Uh^Vud, Rb, Qxu, Ai, Ai, Ai, Ai, Ai, Uu^Em, Ai, Rb, Aa, Aa, Rb^Es, Aa, Aa, Ai, Ai, Ai, Ai, Uh, Rb, Ai, Aa, Rb, Uh^Tf, Aa, Aa, Aa, Aa, Rb, Rb, Uh^Emf, Uh^Emf, Uh^Tf, Cud, Xu, Xu, Xu
Xu, Xu, Qxu, Uh^Tf, Rb^Es, Qxu, Cud, Cud, Xu, Qxu, Qxu, Qxu, Qxu, Ai, Ai, Ai, Ai, Ai, Ai, Uh^Em, Rb, Rb^Es, Ai, Rb^Es, Uh, Ai, Aa, Aa, Uh, Rb, Qxu, Qxu, Qxu, Aa, Rb, Uh^Em, Aa, Uu, Rb, Aa, Rb, Uh^Em, Xu, Xu, Xu, Xu, Xu, Xu
Xu, Xu, Xu, Qxu, Rb^Es, Uh, Xu, Kud, Cud, Qxu, Qxu, Qxu, Qxu, Ai, Ai, Ai, Ai, Ai, Ai, Ai, Ai, Ai, Aa, Aa, Uh, Ai, Aa, Aa, Uh, Rb, Rb, Uu, Rb, Rb, Aa, Aa, Xu, Xu, Uu, Rb, Uu, Uh, Uh, Xu, Xu, Xu, Xu, Xu
Xu, Xu, Xu, Qxu, Rb^Es, Uu^Vud, Xu, Cud, Wwf, Wwg, Wwg, Qxu, Qxu, Qxu, Qxu, Qxu, Ai, Ai, Ai, Ai, Ai, Ai, Xu, Ai, Uu^Em, Uu^Vud, Xu, Uu, Xu, Xu, Xu, Rb^Es, Uh, Xu, Xu, Qxu, Xu, Uh, Uu, Xu, Uh^Em, Xu, Uh^Em, Uu^Vud, Xu, Xu, Xu, Xu
Xu, Xu, Xu, Xu, Xu, Rb^Es, Uu, Wwrg, Wwf, Wwf, Wwrg, Qxu, Wwg, Qxu, Wwf, Qxu, Ai, Ai, Ai, Ai, Xu, Xu, Xu, Rb, Xu, Uh, Uh^Tf, Uh, Xu, Uh^Tf, Rb, Uu, Uh^Tf, Qxu, Qxu, Qxu, Qxu, Xu, Uh, Uh^Emf, Uh^Emf, Uh^Emf, Xu, Xu, Xu, Xu, Xu, Xu
Xu, Cud, Xu, Xu, Xu, Wwf, Wwg, Wwrg, Wwg, Wwf, Wwg, Wwg, Wwg, Wwf, Wwf, Qxu, Qxu, Qxu, Qxu, Rb, Rb, Uh^Tf, Rb, Rb, Rb^Es, Xu, Cud, Xu, Uh^Tf, Uh^Emf, Rb, Uh^Em, Xu, Xu, Xu, Qxu, Rb^Es, Uh, Qxu, Uh^Tf, Xu, Uh^Tf, Cud, Xu, Xu, Xu, Xu, Xu
Uh, Uh^Emf, Uu^Vud, Xu, Wwf, Wwf, Wwf, Wwrg, Wwf, Wwf, Wwf, Wwf, Wwf, Wwf, Qxu, Qxu, Qxu, Qxu, Qxu, Uu^Vud, Xu, Xu, Rb^Emf, Xu, Rb^Es, Xu, Xu, Cud, Xu, Xu, Rb, Uh^Emf, Uh, Cud, Xu, Qxu, Rb, Qxu, Qxu, Qxu, Xu, Xu, Xu, Xu, Xu, Xu, Xu, Xu
Uh, Uu, Uu, Uu, Wwg, Wwf, Wwrg, Wwf, Wwf, Wwf, Wwf, Wwg, Wwrg, Wwg, Wwrg, Wwrg, Wwrg, Qxu, Cud, Qxu, Qxu, Xu, Qxu, Rb^Es, Uh^Em, Qxu, Qxu, Cud, Xu, Rb^Es, Uu, Xu, Xu, Cud, Cud, Xu, Rb^Es, Qxu, Qxu, Xu, Xu, Xu, Xu, Xu, Xu, Xu, Xu, Xu
Uu, Wwrg, Wwrg, Wwg, Wwf, Wwf, Wwf, Wwf, Wwg, Wwf, Wwf, Wwf, Wwrg, Wwrg, Wwrg, Wwrg, Cud, Kud, Xu, Cud, Qxu, Uu^Emf, Rb^Es, Rb^Es, Rb^Es, Rb, Rb, Uh^Tf, Rb^Es, Rb^Es, Xu, Uh, Uh^Emf, Uh^Emf, Uh^Emf, Rb, Xu, Xu, Xu, Xu, Xu, Xu, Xu, Xu, Xu, Xu, Xu, Xu
Wwf, Wwrg, Wwf, Wwg, Wwf, Wwf, Wwf, Wwg, Wwg, Wwf, Wwf, Wwrg, Wwrg, Wwf, Wwf, Wwf, Wwf, Cud, Rb, Rb, Rb, Rb^Es, Rb, Uh^Tf, Xu, Qxu, Xu, Rb, Rb^Emf, Xu, Xu, Uh, Uh^Tf, Uu^Emf, Uu, Xu, Xu, Xu, Xu, Xu, Xu, Xu, Xu, Xu, Xu, Xu, Xu, Xu
Wwf, Wwf, Wwf, Wwf, Wwf, Wwf, Wwf, Wwg, Wwf, Wwg, Wwf, Wwg, Wwf, Wwf, Uu^Vud, Xu, Xu, Rb^Es, Rb, Qxu, Xu, Xu, Uh, Uh^Emf, Rb, Rb^Es, Uh, Uu, Uh, Uu, Rb^Es, Uh, Uu^Emf, Uu^Tf, Xu, Xu, Xu, Xu, Xu, Xu, Xu, Xu, Xu, Xu, Xu, Xu, Xu, Xu
Wwrg, Wwrg, Wwf, Wwf, Wwf, Wwf, Wwf, Wwf, Wwf, Wwf, Wwf, Wwf, Wwf, Rb, Rb, Xu, Xu, Xu, Uu^Em, Rb^Em, Rb^Em, Uh, Xu, Uu, Xu, Rb^Emf, Uh^Emf, Uh^Em, Uh^Emf, Xu, Xu, Xu, Cud, Xu, Xu, Xu, Xu, Xu, Xu, Xu, Xu, Xu, Xu, Xu, Xu, Xu, Xu, Xu
Wwg, Wwg, Wwg, Wwg, Wwg, Wwg, Wwf, Wwf, Uu^Es, Wwf, Uh, Uu, Wwf, Uh^Emf, Xu, Uh^Emf, Uu, Uu^Em, Uu, Uh, Uh^Emf, Uh^Emf, Uh^Tf, Uu^Vud, Cud, Uh, Xu, Uh^Tf, Xu, Xu, Xu, Xu, Xu, Xu, Xu, Xu, Xu, Xu, Xu, Xu, Xu, Xu, Xu, Xu, Xu, Xu, Xu, Xu
Wwg, 1 Wwg, Wwg, Wwg, Wwf, Wwf, Wwf, Wwf, Uh^Emf, Uu^Vud, Xu, Xu, Cud, Xu, Xu, Xu, Xu, Xu, Xu, Qxu, Qxu, Qxu, Xu, Xu, Xu, Cud, Xu, Xu, Xu, Xu, Xu, Xu, Xu, Xu, Xu, Xu, Xu, Xu, Xu, Xu, Xu, Xu, Xu, Xu, Xu, Xu, Xu, Xu
Wwg, Wwg, Wwg, Wwg, Wwg, Uu, Uu, Uu, Uu, Uh^Emf, Xu, Xu, Xu, Xu, Xu, Xu, Xu, Xu, Xu, Xu, Xu, Xu, Xu, Xu, Xu, Xu, Xu, Xu, Xu, Xu, Xu, Xu, Xu, Xu, Xu, Xu, Xu, Xu, Xu, Xu, Xu, Xu, Xu, Xu, Xu, Xu, Xu, Xu
