Xu, Xu, Xu, Xu, Xu, Xu, Xu, Xu, Xu, Xu, Xu, Xu, Xu, Xu, Xu, Xu, Xu, Xu, Xu, Xu, Xu, Xu, Xu, Xu, Xu, Xu, Xu, Xu, Xu, Xu, Xu, Xu, Xu, Xu, Xu, Xu, Xu, Xu, Xu, Xu, Xu, Xu, Xu, Xu, Xu, Xu, Xu, Xu
Xu, Xu, Xu, Xu, Xu, Xu, Xu, Xu, Xu, Xu, Xu, Xu, Xu, Xu, Xu, Xu, Xu, Xu, Xu, Xu, Xu, Xu, Xu, Xu, Xu, Xu, Xu, Xu, Xu, Xu, Xu, Xu, Xu, Xu, Xu, Xu, Xu, Xu, Xu, Xu, Xu, Xu, Xu, Xu, Xu, Xu, Xu, Xu
Xu, Xu, Xu, Xu, Xu, Xu, Xu, Xu, Xu, Xu, Xu, Xu, Xu, Xu, Xu, Xu, Xu, Xu, Xu, Xu, Xu, Xu, Xu, Xu, Xu, Xu, Xu, Xu, Xu, Xu, Xu, Xu, Xu, Xu, Xu, Xu, Xu, Xu, Xu, Xu, Xu, Xu, Xu, Xu, Xu, Xu, Xu, Xu
Xu, Xu, Xu, Xu, Xu, Xu, Xu, Xu, Xu, Xu, Xu, Xu, Xu, Xu, Xu, Xu, Xu, Xu, Xu, Xu, Xu, Xu, Cud, Xu, Xu, Xu, Xu, Xu, Xu, Xu, Cud, Xu, Xu, Xu, Xu, Xu, Xu, Xu, Xu, Xu, Xu, Xu, Xu, Xu, Xu, Xu, Xu, Xu
Xu, Xu, Xu, Xu, Xu, Xu, Xu, Xu, Xu, Xu, Xu, Xu, Xu, Cud, Xu, Xu, Xu, Xu, Xu, Xu, Xu, Xu, Uh^Emf, Xu, Xu, Uu^Vud, Xu, Xu, Uh^Tf, Xu, Uh^Tf, Xu, Xu, Xu, Xu, Xu, Cud, Xu, Xu, Xu, Xu, Xu, Xu, Xu, Xu, Xu, Xu, Xu
Xu, Xu, Xu, Xu, Xu, Xu, Xu, Xu, Xu, Cud, Uh, Uh^Tf, Uh^Tf, Uh^Tf, Uh^Emf, Xu, Xu, Xu, Uh^Emf, Uh^Tf, Uh^Em, Uh^Tf, Xu, Uh^Emf, Uu, Uh, Isa^Esa, Uh^Em, Isa, Uh^Emf, Uu, Xu, Xu, Xu, Xu, Xu, Uh^Tf, Xu, Xu, Xu, Xu, Xu, Xu, Xu, Xu, Xu, Xu, Xu
Xu, Xu, Xu, Xu, Xu, Xu, Xu, Xu, Xu, Xu, Uu, Uh^Emf, Xu, Xu, Isa, Uh^Vud, Uu^Em, Isa, Aa, Uh^Emf, Xu, Xu, Isa, Uu, Aa, Xu, Aa^Esa, Aa, Isa, Aa^Esa, Isa^Es, Uu, Uh^Em, Uh^Tf, Uh^Emf, Uh^Tf, Uh^Emf, Xu, Xu, Xu, Xu, Xu, Xu, Xu, Xu, Xu, Xu, Xu
Xu, Xu, Xu, Xu, Xu, Xu, Xu, Xu, Xu, Xu, Xu, Rb^Em, Xu, Xu, Aa^Esa, Isa^Esa, Aa^Esa, Isa^Es, Aa, Aa^Esa, Aa^Esa, Aa, Isa^Es, Uh, Uh^Tf, Aa, Aa^Esa, Aa^Esa, Uu, Isa^Es, Aa, Aa^Esa, Aa^Esa, Uu^Em, Aa^Esa, Aa, Uh^Em, Xu, Xu, Xu, Xu, Xu, Xu, Xu, Xu, Xu, Xu, Xu
Xu, Xu, Xu, Xu, Xu, Xu, Xu, Xu, Xu, Xu, Uh, Uu^Es, Isa^Es, Aa, Aa, Aa^Esa, Aa, Aa, Uh, Aa^Esa, Isa, Isa^Es, Isa^Es, Qxu, Uh^Emf, Aa^Esa, Aa, Ai, Ai, Uh^Tf, Uh^Emf, Aa, Aa, Aa, Aa, Xu, Rb, Uh^Tf, Uh^Emf, Xu, Uh^Tf, Cud, Xu, Xu, Xu, Xu, Xu, Xu
Xu, Xu, Xu, Xu, Xu, Xu, Xu, Cud, Uh^Tf, Uh^Emf, Xu, Xu, Aa, Isa, Uh^Em, Ai, Ai, Uh^Tf, Uh^Tf, Uu, Aa, Uu^Vud, Aa, Aa, Ai, Uh, Uh^Vud, Ai, Uh, Uh^Emf, Aa, Uu^Vud, Aa^Esa, Aa, Qxu, Aa^Esa, Isa^Es, Rb^Em, Xu, Uh^Emf, Uh^Emf, Xu, Xu, Xu, Xu, Xu, Xu, Xu
Xu, Xu, Xu, Xu, Xu, Xu, Xu, Xu, Uh, Uh, Xu, Aa^Esa, Aa^Esa, Qxu, Uu^Em, Uh^Em, Uh, Uh^Emf, Rb^Es, Uh, Uu, Ai, Ai, Ai, Cud, Cud, Cud, Uu, Ai, Uh, Ai, Ai, Aa^Esa, Uh^Tf, Qxu, Isa, Isa, Aa^Esa, Aa^Esa, Aa, Uu^Vud, Xu, Xu, Xu, Xu, Xu, Xu, Xu
Xu, Xu, Xu, Xu, Xu, Xu, Uh^Tf, Uh^Tf, Uh^Emf, Uh^Em, Uh^Emf, Aa^Esa, Ai, Qxu, Ai, Uh, Aa^Esa, Uu, Ai, Rb^Es, Ai, Ai, Qxu, Uu, Cud, 3 Kud, Cud, Qxu, Ai, Ai, Ai, Ai, Ai, Isa^Vud, Isa, Qxu, Uu, Isa^Es, Isa, Isa^Es, Xu, Uh^Emf, Uh^Tf, Xu, Xu, Xu, Xu, Xu
Xu, Xu, Xu, Xu, Xu, Xu, Xu, Uh^Em, Rb, Aa, Rb^Es, Uh^Tf, Aa, Ai, Aa, Aa^Esa, Aa, Uh^Vud, Cud, Qxu, Qxu, Ai, Aa^Esa, Qxu, Qxu, Isa, Qxu, Qxu, Ai, Ai, Qxu, Qxu, Cud, Aa, Uu, Isa^Esa, Aa^Esa, Aa^Esa, Aa, Aa^Esa, Aa^Esa, Uh^Emf, Uh^Tf, Xu, Cud, Xu, Xu, Xu
Xu, Xu, Xu, Xu, Xu, Xu, Uh^Vud, Uh^Em, Xu, Xu, Qxu, Rb^Es, Isa^Em, Ai, Isa, Isa, Isa, Cud, 4 Kud, Cud, Qxu, Aa, Aa^Esa, Aa^Esa, Qxu, Uu^Xo, Qxu, Aa, Aa^Esa, Ai, Qxu, Cud, 5 Kud, Cud, Isa, Isa^Esa, Ai, Aa, Uh^Tf, Aa^Esa, Aa, Uu^Em, Uh^Emf, Uh^Tf, Xu, Xu, Xu, Xu
Xu, Xu, Xu, Cud, Uh^Tf, Uh, Xu, Uh, Xu, Aa^Esa, Qxu, Isa^Es, Isa^Es, Uu^Em, Uu^Es, Aa^Esa, Aa, Cud, Cud, Isa, Uu^Xo, Qxu, Aa, Aa, Ai, Qxu, Ai, Aa^Esa, Aa^Esa, Qxu, Uu^Xo, Isa, Cud, Cud, Uh, Isa, Isa, Uh, Aa^Esa, Isa, Isa^Es, Isa^Es, Uu^Es, Uh^Em, Xu, Xu, Xu, Xu
Xu, Xu, Xu, Xu, Xu, Rb, Xu, Aa, Aa^Esa, Aa^Esa, Isa^Es, Isa, Uu^Vud, Ai, Ai, Aa, Ai, Qxu, Qxu, Qxu, Qxu, Qxu, Ai, Aa^Esa, Ai, Ai, Ai, Aa, Ai, Qxu, Qxu, Qxu, Qxu, Qxu, Aa^Esa, Isa^Es, Uu, Ai, Ai, Ai, Isa^Esa, Aa^Esa, Uh, Uu^Vud, Xu, Xu, Xu, Xu
Xu, Xu, Xu, Uh^Tf, Uu^Emf, Rb^Es, Xu, Aa, Uh^Emf, Uh^Emf, Xu, Isa^Es, Ai, Ai, Ai, Ai, Ai, Aa^Esa, Ai, Aa, Aa^Esa, Aa^Esa, Aa, Ai, Ai, 2 Ai, Ai, Ai, Aa, Aa^Esa, Aa^Esa, Aa^Esa, Ai, Ai, Ai, Isa^Es, Uu^Vud, Isa, Aa, Aa^Esa, Aa^Esa, Uu, Xu, Uu^Es, Uh^Emf, Xu, Xu, Xu
Xu, Xu, Uh^Tf, Uh^Emf, Xu, Uh, Isa, Isa, Uu^Em, Uh^Tf, Isa, Isa, Uu, Isa, Uu, Ai, Uh, Ai, Ai, Aa, Aa, Aa^Esa, Ai, Ai, Ai, Ai, Ai, Ai, Ai, Aa^Esa, Aa, Ai, Ai, Ai, Aa^Esa, Aa^Esa, Isa, Isa^Es, Isa, Uh, Uh, Aa, Uh, Isa^Esa, Uu^Em, Uh^Emf, Uh^Tf, Xu
Xu, Xu, Xu, Uh^Emf, Xu, Xu, Isa^Es, Xu, Isa^Es, Uu^Em, Ai, Ai, Isa^Esa, Aa, Aa, Uh, Aa^Esa, Isa^Es, Qxu, Aa^Esa, Qxu, Aa, Qxu, Aa, Ai, Ai, Ai, Aa^Esa, Qxu, Aa, Qxu, Aa, Ai, Ai, Isa, Aa, Isa, Isa, Ai, Qxu, Qxu, Uu, Xu, Aa^Esa, Uh, Uh^Emf, Xu, Xu
Xu, Xu, Xu, Uh, Uu^Em, Isa^Es, Qxu, Uu^Vud, Qxu, Isa, Uh^Es, Isa, Aa^Esa, Aa^Esa, Ai, Aa, Uh, Isa^Es, Qxu, Qxu, Cud, Qxu, Uu^Xo, Qxu, Aa, Aa^Esa, Aa, Qxu, Uu^Xo, Qxu, Cud, Qxu, Isa^Es, Isa^Es, Isa^Es, Isa^Es, Isa, Uh, Ai, Aa, Qxu, Isa, Isa, Xu, Uu^Vud, Xu, Xu, Xu
Xu, Cud, Uh^Tf, Uu^Emf, Isa, Isa, Xu, Qxu, Qxu, Xu, Uh, Isa^Es, Aa, Ai, Aa, Aa^Esa, Uh, Uh^Emf, Uh^Tf, Cud, 7 Kud, Isa, Qxu, Qxu, Aa, Aa^Esa, Aa^Esa, Qxu, Qxu, Isa, 6 Kud, Cud, Uh, Uh, Uh^Vud, Ai, Uh, Uh^Tf, Ai, Aa^Esa, Aa^Esa, Qxu, Uh^Emf, Uh^Emf, Xu, Xu, Xu, Xu
Xu, Qxu, Isa^Es, Uh^Emf, Uh^Emf, Xu, Xu, Uh^Tf, Rb, Uh, Uu, Uu^Em, Uu, Aa, Ai, Aa^Esa, Uh, Ai, Ai, Cud, Cud, Cud, Qxu, Ai, Ai, Aa^Esa, Ai, Ai, Qxu, Cud, Cud, Cud, Uu, Isa^Es, Ai, Ai, Rb^Es, Uh^Emf, Uu, Aa^Esa, Xu, Xu, Uh^Tf, Uh^Tf, Xu, Xu, Xu, Xu
Xu, Qxu, Isa^Es, Qxu, Uh, Uh^Tf, Xu, Uh^Tf, Rb, Xu, Qxu, Uh, Ai, Ai, Ai, Uu^Vud, Uh, Ai, Uh, Uh, Aa^Esa, Qxu, Aa^Esa, Ai, Ai, Ai, Ai, Ai, Uh, Uu, Ai, Ai, Isa, Ai, Uh, Uh, Aa^Esa, Rb, Aa^Esa, Isa, Uh, Uh^Em, Xu, Uu^Em, Xu, Xu, Xu, Xu
Xu, Xu, Xu, Isa^Es, Rb^Es, Rb^Emf, Rb^Es, Rb^Emf, Qxu, Uh^Vud, Isa, Qxu, Ai, Ai, Ai, Ai, Ai, Uu^Em, Ai, Isa, Aa, Aa, Isa^Es, Aa^Esa, Aa, Ai, Ai, Ai, Ai, Uh, Isa, Ai, Aa^Esa, Isa^Esa, Uh^Tf, Aa, Aa, Aa^Esa, Aa, Isa, Isa^Esa, Uh^Emf, Uh^Emf, Uh^Tf, Cud, Xu, Xu, Xu
Xu, Xu, Qxu, Uh^Tf, Isa^Es, Qxu, Cud, Cud, Xu, Qxu, Qxu, Qxu, Qxu, Ai, Ai, Ai, Ai, Ai, Ai, Uh^Em, Isa, Isa^Es, Ai, Isa^Es, Uh, Ai, Aa^Esa, Aa, Uh, Isa, Qxu, Qxu, Qxu, Aa, Isa^Esa, Uh^Em, Aa, Uu, Isa, Aa^Esa, Isa^Esa, Uh^Em, Xu, Xu, Xu, Xu, Xu, Xu
Xu, Xu, Xu, Qxu, Isa^Es, Uh, Xu, Kud, Cud, Qxu, Qxu, Qxu, Qxu, Ai, Ai, Ai, Ai, Ai, Ai, Ai, Ai, Ai, Aa^Esa, Aa^Esa, Uh, Ai, Aa^Esa, Aa^Esa, Uh, Isa, Isa, Uu, Isa, Isa, Aa^Esa, Aa^Esa, Xu, Xu, Uu, Isa, Uu, Uh, Uh, Xu, Xu, Xu, Xu, Xu
Xu, Xu, Xu, Qxu, Isa^Es, Uu^Vud, Xu, Cud, Wwf, Wwg, Wwg, Qxu, Qxu, Qxu, Qxu, Qxu, Ai, Ai, Ai, Ai, Ai, Ai, Xu, Ai, Uu^Em, Uu^Vud, Xu, Uu, Xu, Xu, Xu, Isa^Es, Uh, Xu, Xu, Qxu, Xu, Uh, Uu, Xu, Uh^Em, Xu, Uh^Em, Uu^Vud, Xu, Xu, Xu, Xu
Xu, Xu, Xu, Xu, Xu, Isa^Es, Uu, Wwrg, Wwf, Wwf, Wwrg, Qxu, Wwg, Qxu, Wwf, Qxu, Ai, Ai, Ai, Ai, Xu, Xu, Xu, Isa, Xu, Uh, Uh^Tf, Uh, Xu, Uh^Tf, Isa, Uu, Uh^Tf, Qxu, Qxu, Qxu, Qxu, Xu, Uh, Uh^Emf, Uh^Emf, Uh^Emf, Xu, Xu, Xu, Xu, Xu, Xu
Xu, Cud, Xu, Xu, Xu, Wwf, Wwg, Wwrg, Wwg, Wwf, Wwg, Wwg, Wwg, Wwf, Wwf, Qxu, Qxu, Qxu, Qxu, Isa, Isa, Uh^Tf, Isa, Isa, Isa^Es, Xu, Cud, Xu, Uh^Tf, Uh^Emf, Isa, Uh^Em, Xu, Xu, Xu, Qxu, Isa^Es, Uh, Qxu, Uh^Tf, Xu, Uh^Tf, Cud, Xu, Xu, Xu, Xu, Xu
Uh, Uh^Emf, Uu^Vud, Xu, Wwf, Wwf, Wwf, Wwrg, Wwf, Wwf, Wwf, Wwf, Wwf, Wwf, Qxu, Qxu, Qxu, Qxu, Qxu, Uu^Vud, Xu, Xu, Rb^Emf, Xu, Isa^Es, Xu, Xu, Cud, Xu, Xu, Isa, Uh^Emf, Uh, Cud, Xu, Qxu, Isa, Qxu, Qxu, Qxu, Xu, Xu, Xu, Xu, Xu, Xu, Xu, Xu
Uh, Uu, Uu, Uu, Wwg, Wwf, Wwrg, Wwf, Wwf, Wwf, Wwf, Wwg, Wwrg, Wwg, Wwrg, Wwrg, Wwrg, Qxu, Cud, Qxu, Qxu, Xu, Qxu, Rb^Es, Uh^Em, Qxu, Qxu, Cud, Xu, Isa^Es, Uu, Xu, Xu, Cud, Cud, Xu, Isa^Es, Qxu, Qxu, Xu, Xu, Xu, Xu, Xu, Xu, Xu, Xu, Xu
Uu, Wwrg, Wwrg, Wwg, Wwf, Wwf, Wwf, Wwf, Wwg, Wwf, Wwf, Wwf, Wwrg, Wwrg, Wwrg, Wwrg, Cud, Kud, Xu, Cud, Qxu, Uu^Emf, Isa^Es, Isa^Es, Isa^Es, Isa, Isa, Uh^Tf, Rb^Es, Isa^Es, Xu, Uh, Uh^Emf, Uh^Emf, Uh^Emf, Rb, Xu, Xu, Xu, Xu, Xu, Xu, Xu, Xu, Xu, Xu, Xu, Xu
Wwf, Wwrg, Wwf, Wwg, Wwf, Wwf, Wwf, Wwg, Wwg, Wwf, Wwf, Wwrg, Wwrg, Wwf, Wwf, Wwf, Wwf, Cud, Isa, Isa, Isa, Isa^Es, Isa, Uh^Tf, Xu, Qxu, Xu, Rb, Rb^Emf, Xu, Xu, Uh, Uh^Tf, Uu^Emf, Uu, Xu, Xu, Xu, Xu, Xu, Xu, Xu, Xu, Xu, Xu, Xu, Xu, Xu
Wwf, Wwf, Wwf, Wwf, Wwf, Wwf, Wwf, Wwg, Wwf, Wwg, Wwf, Wwg, Wwf, Wwf, Uu^Vud, Xu, Xu, Isa^Es, Isa, Qxu, Xu, Xu, Uh, Uh^Emf, Rb, Isa^Es, Uh, Uu, Uh, Uu, Isa^Es, Uh, Uu^Emf, Uu^Tf, Xu, Xu, Xu, Xu, Xu, Xu, Xu, Xu, Xu, Xu, Xu, Xu, Xu, Xu
Wwrg, Wwrg, Wwf, Wwf, Wwf, Wwf, Wwf, Wwf, Wwf, Wwf, Wwf, Wwf, Wwf, Isa, Isa, Xu, Xu, Xu, Uu^Em, Rb^Em, Rb^Em, Uh, Xu, Uu, Xu, Rb^Emf, Uh^Emf, Uh^Em, Uh^Emf, Xu, Xu, Xu, Cud, Xu, Xu, Xu, Xu, Xu, Xu, Xu, Xu, Xu, Xu, Xu, Xu, Xu, Xu, Xu
Wwg, Wwg, Wwg, Wwg, Wwg, Wwg, Wwf, Wwf, Uu^Es, Wwf, Uh, Uu, Wwf, Uh^Emf, Xu, Uh^Emf, Uu, Uu^Em, Uu, Uh, Uh^Emf, Uh^Emf, Uh^Tf, Uu^Vud, Cud, Uh, Xu, Uh^Tf, Xu, Xu, Xu, Xu, Xu, Xu, Xu, Xu, Xu, Xu, Xu, Xu, Xu, Xu, Xu, Xu, Xu, Xu, Xu, Xu
Wwg, 1 Wwg, Wwg, Wwg, Wwf, Wwf, Wwf, Wwf, Uh^Emf, Uu^Vud, Xu, Xu, Cud, Xu, Xu, Xu, Xu, Xu, Xu, Qxu, Qxu, Qxu, Xu, Xu, Xu, Cud, Xu, Xu, Xu, Xu, Xu, Xu, Xu, Xu, Xu, Xu, Xu, Xu, Xu, Xu, Xu, Xu, Xu, Xu, Xu, Xu, Xu, Xu
Wwg, Wwg, Wwg, Wwg, Wwg, Uu, Uu, Uu, Uu, Uh^Emf, Xu, Xu, Xu, Xu, Xu, Xu, Xu, Xu, Xu, Xu, Xu, Xu, Xu, Xu, Xu, Xu, Xu, Xu, Xu, Xu, Xu, Xu, Xu, Xu, Xu, Xu, Xu, Xu, Xu, Xu, Xu, Xu, Xu, Xu, Xu, Xu, Xu, Xu
